
лекарственнымисредствами - лекарственными средствами
Неселективныеингибиторы - Неселективные ингибиторы
Неселективныебета-адреноблокатор - Неселективные бета-адреноблокатор
Другиемиорелаксанты - Другие миорелаксанты
миорелаксантыцентрального - миорелаксанты центрального
ингибиторыобратного - ингибиторы обратного
захватамоноаминов - захвата моноаминов
центральногодействия - центрального действия
периферическогодействия - периферического действия
нейротоксинтипа - нейротоксин типа
еепроизводные - ее производные
Селективныеингибиторы - Селективные ингибиторы
Производныебензодиазепина - Производные бензодиазепина
захватасеротонина - захвата серотонина
миорелаксантыпериферического - миорелаксанты периферического
адреноблокаторы - адреноблокаторы
Другиеантидепрессанты - Другие антидепрессанты
Неселективныебета-адреноблокаторы - Неселективные бета-адреноблокаторы
витаминныепрепараты - витаминные препараты
Алкалоидыбелладонны, - Алкалоиды белладонны,
иразбавители, - и разбавители,
иноотропные - и ноотропные
препаратыдля - препараты для
Антихолинэргические - Антихолинэргические
Другиепсихостимуляторы - Другие психостимуляторы
ноотропныепрепараты - ноотропные препараты
кромепротивоглаукомных - кроме противоглаукомных
лечениязаболеваний - лечения заболеваний
Симпатомиметики,кроме - Симпатомиметики, кроме
белладонны,третичные - белладонны, третичные
противоглаукомныхпрепаратов - противоглаукомных препаратов
включаяирригационные - включая ирригационные
Другиеаминогликозиды - Другие аминогликозиды
ирригационныерастворы - ирригационные растворы
аминобензойнойкислоты - аминобензойной кислоты
Эфирыаминобензойной - Эфиры аминобензойной
Аскорбиноваякислота - Аскорбиновая кислота
разбавители,включая - разбавители, включая
одновременнымупотреблением - одновременным употреблением
седативныхили - седативных или
употреблениемгаллюциногенов - употреблением галлюциногенов
другихпсихоактивных - других психоактивных
другихстимуляторов, - других стимуляторов,
летучихрастворителей - летучих растворителей
нервнойсистемы - нервной системы
протеазплазмы - протеаз плазмы
магнияаспарагинат - магния аспарагинат
нарушенийобмена - нарушений обмена
Пиперидиновыепроизводные - Пиперидиновые производные
илбензодиазепинмг - илбензодиазепин мг
Димеркаптопропансульфонат - Димеркаптопропансульфонат
егопроизводные - его производные
Производныежирных - Производные жирных
натриямг - натрия мг
парентеральногопитания - парентерального питания
Растворыэлектролитов - Растворы электролитов
антисептикии - антисептики и
Алифатическиепроизводные - Алифатические производные
наводно-электролитный - на водно-электролитный
Гопантеноваякислота - Гопантеновая кислота
сфонилдиметилатмл - сфонилдиметилат мл
Другиеирригационные - Другие ирригационные
препаратымл - препараты мл
дляпарентерального - для парентерального
Глутаминоваякислота - Глутаминовая кислота
Аминокислоты,углеводы, - Аминокислоты, углеводы,
аспарагинатмл - аспарагинат мл
зеленыймл - зеленый мл
Гамма-аминомасляная - Гамма-аминомасляная
витаминыв - витамины в
Фосфолипидымг - Фосфолипиды мг
Бриллиантовыйзеленый - Бриллиантовый зеленый
Никотиноилгамма-аминомасляна - Никотиноил гамма-аминомасляна
ипрепараты - и препараты
Другиеантипсихотические - Другие антипсихотические
желудочно-кишечного - желудочно-кишечного
слабительныесредства - слабительные средства
приалкогольной - при алкогольной
лечебныесредства - лечебные средства
плазмыкрови - плазмы крови
длялечения - для лечения
дезинфицирующиесредства - дезинфицирующие средства
сукцинатмг - сукцинат мг
N-карбамоилметил-4-фенил-2-пирролидон - N-карбамоилметил-4-фенил-2-пирролидон
минеральныевещества, - минеральные вещества,
Бромдигидрохлорфенилбензодиазепин - Бромдигидрохлорфенилбензодиазепин
Глицирризиноваякислота - Глицирризиновая кислота
хлоридмл - хлорид мл
прочиепрепараты - прочие препараты
минеральныевещества - минеральные вещества
Этилметилгидроксипиридина - Этилметилгидроксипиридина
Гидроксиэтилкрахмал - Гидроксиэтилкрахмал
производныефенотиазина - производные фенотиазина
Производныекарбоксамида - Производные карбоксамида
алкогольнойзависимости - алкогольной зависимости
иее - и ее
Производныебутирофенона - Производные бутирофенона
заболеванийпечени - заболеваний печени
влияющиена - влияющие на
гамма-аминомасляная - гамма-аминомасляная
Производныедифенилметана - Производные дифенилметана
Синтетическиеантихолинергические средства, эфиры с третичной аминогруппой - Синтетические антихолинергические средства, эфиры с третичной аминогруппой
Производныексантина - Производные ксантина
родственныесоединения - родственные соединения
ихпроизводные - их производные
Бензодиазепино-подобные - Бензодиазепино-подо бные
углеводы,минеральные - углеводы, минеральные
Диметилоксобутилфосфонилдиметилат - Диметилоксобутилфосфонилдиметилат
водно-электролитныйбаланс - водно-электролитный баланс
Стерофундинизотонический - Стерофундин изотонический
кислотамг - кислота мг
Производныетиоксантена - Производные тиоксантена
Контактныеслабительные - Контактные слабительные
лмл - л мл
заболеванийжелудочно-кишечног - заболеваний желудочно-кишечног
фенил-2-пирролидонмг - фенил-2-пирролидон мг
иродственные - и родственные
Производныеуксусной - Производные уксусной
антипсихотическиесредства - антипсихотические средства
изотоническиймл - изотонический мл
бета-адреноблокаторы - бета-адреноблокаторы
Селективныебета-адреноблокаторы - Селективные бета-адреноблокаторы
Препараты,применяемые при алкогольной зависимости - Препараты, применяемые при алкогольной зависимости
Антихолинэргическиесредства - Антихолинэргические средства
проницаемостькапилляров - проницаемость капилляров
Ингибиторыкарбоангидразы - Ингибиторы карбоангидразы
противовоспалительныепрепараты - противовоспалительные препараты
препараты,снижающие - препараты, снижающие
устраненияголовокружения - устранения головокружения
кислота(витамин - кислота (витамин
препятствующиеновообразованию - препятствующие новообразованию
нуклеотиды,кроме - нуклеотиды, кроме
ингибиторовобратной - ингибиторов обратной
Другиепарасимпатомиметики - Другие парасимпатомиметики
длянаружного - для наружного
противомикробныепрепараты - противомикробные препараты
уксуснойкислоты - уксусной кислоты
3-гопоколения - 3-го поколения
гепариноидыдля - гепариноиды для
Нестероидныепротивовоспалительные - Нестероидные противовоспалительные
Этилметилгидроксипиридинасукцинат - Этилметилгидроксипиридина сукцинат
Другиеантигистаминные - Другие антигистаминные
Смектитдиоктаэдрический - Смектит диоктаэдрический
хлорид+Натрияхлорид+Натрия - хлорид+Натрия хлорид+Натрия
Декстрозамл 1000 6000 - Декстроза мл 1000 6000
препаратыдругие - препараты другие
третичнойаминогруппой - третичной аминогруппой
хлорид]мл - хлорид] мл
ацетат+Натрияглюконат+Натрия - ацетат+Натрия глюконат+Натрия
системногодействия - системного действия
противовирусныепрепараты - противовирусные препараты
Иммуноглобулинчеловека - Иммуноглобулин человека
[человеческийгенно-инженерный] - [человеческий генно-инженерный]
[Калияхлорид+Кальция - [Калия хлорид+Кальция
Другиеиммуностимуляторы - Другие иммуностимуляторы
Иммуноглобулинынормальные - Иммуноглобулины нормальные
растворсложный - раствор сложный
стретичной - с третичной
эфирмг - эфир мг
сукцинатмл - сукцинат мл
Производныепиперазина - Производные пиперазина
Декстроза+Калияхлорид+Натрия - Декстроза+Калия хлорид+Натрия
короткогодействия и их аналоги для инъекционного введения - короткого действия и их аналоги для инъекционного введения
бифидум+Лизоцимдоза - бифидум+Лизоцим доза
сполипептидами - с полипептидами
хлорид+Магнияхлорид+Натрия - хлорид+Магния хлорид+Натрия
Прочиепротивовирусные - Прочие противовирусные
Производныепропионовой - Производные пропионовой
антихолинергическиесредства, - антихолинергические средства,
Противодиарейныемикроорганизмы - Противодиарейные микроорганизмы
кефирныекапсула - кефирные капсула
антигистаминныесредства - антигистаминные средства
Бифидобактериибифидум - Бифидобактерии бифидум
растворимый[человеческий - растворимый [человеческий
метиламинометил-гидроксиброминдол - метиламинометил-гидрок сиброминдол
нормальныечеловеческие - нормальные человеческие
хлорид+Кальцияхлорид+Натрия - хлорид+Кальция хлорид+Натрия
бифидумдоза - бифидум доза
нормальныймг - нормальный мг
Лактобактерииацидофильные+Грибки - Лактобактерии ацидофильные+Грибки
хлорид+Натрияацетат+Натрия - хлорид+Натрия ацетат+Натрия
цитратмл - цитрат мл
желудочно-кишечноготракта - желудочно-кишечного тракта
Адсорбирующиекишечные - Адсорбирующие кишечные
Бифидобактериибифидум+Лизоцим - Бифидобактерии бифидум+Лизоцим
карбоновойкислоты - карбоновой кислоты
Метилфенилтиометил-диметиламинометил-гидрок - Метилфенилтиометил-ди метиламинометил-гидрок
ацидофильные+Грибкикефирные - ацидофильные+Грибки кефирные
Синтетическиеантихолинергические - Синтетические антихолинергические
моторикижелудочно-кишечного - моторики желудочно-кишечного
натриясукцинат - натрия сукцинат
включаякомбинации - включая комбинации
питаниямл - питания мл
Декстроза+Калияхлорид+Магния - Декстроза+Калия хлорид+Магния
[Калиямл - [Калия мл
препаратысульфаниламидов и триметоприма, включая производные - препараты сульфаниламидов и триметоприма, включая производные
Комбинированныепрепараты - Комбинированные препараты
фолиевойкислоты - фолиевой кислоты
кислота]г - кислота] г
противоревматическиепрепараты - противоревматические препараты
Антиаритмическиепрепараты, - Антиаритмические препараты,
Амоксициллин+[Клавулановая - Амоксициллин+[Клавуланова я
нестероидныепротивовоспалительные - нестероидные противовоспалительные
пенициллинов,включая - пенициллинов, включая
заболеванийжелудочно-кишечного - заболеваний желудочно-кишечного
дляобщей - для общей
сингибиторами - с ингибиторами
Производныефенилпиперидина - Производные фенилпиперидина
ипротиворевматические - и противоревматические
обменавеществ - обмена веществ
образованиямочевой - образования мочевой
Антибиотикигликопептидной - Антибиотики гликопептидной
гематологическиесредства - гематологические средства
противогрибковыепрепараты - противогрибковые препараты
Парамагнитныеконтрастные - Парамагнитные контрастные
контрастныесредства - контрастные средства
болезнях,классифицированных - болезнях, классифицированных
цитратг - цитрат г
вещества,витамины - вещества, витамины
Антихолинэстеразныесредства - Антихолинэстеразные средства
сосмодиуретическим - с осмодиуретическим
человеканормальный - человека нормальный
В12(цианокобаламин - В12 (цианокобаламин
егоаналоги) - его аналоги)
осмодиуретическимдействием - осмодиуретическим действием
обратнойтранскриптазы - обратной транскриптазы
IgA]г - IgA] г
Натрияцитрат - Натрия цитрат
трехвалентногожелеза - трехвалентного железа
Пероральныепрепараты - Пероральные препараты
гидроксидполимальтозат - гидроксид полимальтозат
препаратытрехвалентного - препараты трехвалентного
полимальтозатмкг - полимальтозат мкг
егоаналоги - его аналоги
назначениялекарственных - назначения лекарственных
дофаминергическиесредства - дофаминергические средства
изделий),включенных - изделий), включенных
идофаминергические - и дофаминергические
сосмешанным - со смешанным
Моноклональныеантитела - Моноклональные антитела
аспарагинатмг - аспарагинат мг
иподобные - и подобные
трикалиядицитрат - трикалия дицитрат
антицитомегаловирусныймл - антицитомегаловирусный мл
человекаантицитомегаловирусный - человека антицитомегаловирусный
вкомбинации - в комбинации
включаяпроизводные - включая производные
игастроэзофагальной - и гастроэзофагальной
Иммуноглобулины,нормальные - Иммуноглобулины, нормальные
Гормоны,замедляющие - Гормоны, замедляющие
активностью(группа - активностью (группа
[IgG+IgM+IgA]мг - [IgG+IgM+IgA] мг
Цефоперазон+[Сульбактам] - Цефоперазон+[Сульбакта м]
дицитратмг - дицитрат мг
Антагонистывитамина - Антагонисты витамина
Колониестимулирующие - Колониестимулирующие
снизкой - с низкой
двенадцатиперстнойкишки - двенадцатиперстной кишки
м]мг - м] мг
Другиеиммунодепрессанты - Другие иммунодепрессанты
инуклеотиды, - и нуклеотиды,
Препаратыкальцитонина - Препараты кальцитонина
Противовирусныепрепараты - Противовирусные препараты
Производныетриазола - Производные триазола
нормальный[IgG+IgM+IgA] - нормальный [IgG+IgM+IgA]
Специфическиеиммуноглобулины - Специфические иммуноглобулины
триметоприма,включая - триметоприма, включая
Селективныеиммунодепрессанты - Селективные иммунодепрессанты
препаратысульфаниламидов - препараты сульфаниламидов
Ингибиторыпротонового - Ингибиторы протонового
сдругими - с другими
гликопептиднойструктуры - гликопептидной структуры
Органическиенитраты - Органические нитраты
Антагонистыальдостерона - Антагонисты альдостерона
Производныедигидропиридина - Производные дигидропиридина
эректильнойдисфункции - эректильной дисфункции
азотистогоиприта - азотистого иприта
смешанныммеханизмом - смешанным механизмом
Муколитическиепрепараты - Муколитические препараты
Производныефенилалкиламина - Производные фенилалкиламина
кромеингибиторов - кроме ингибиторов
идвенадцатиперстной - и двенадцатиперстной
итриметоприма, - и триметоприма,
Колекальциферолмг - Колекальциферол мг
Антагонистыангиотензина - Антагонисты ангиотензина
язвеннойболезни - язвенной болезни
гастроэзофагальнойрефлюксной - гастроэзофагальной рефлюксной
Прочиегематологические - Прочие гематологические
Производныебензотиазепина - Производные бензотиазепина
Другиепротивомикробные - Другие противомикробные
дляпрофилактики - для профилактики
Натрияглицирризинат - Натрия глицирризинат
пропионовойкислоты - пропионовой кислоты
Антихолинергическиесредства - Антихолинергические средства
противокашлевыесредства - противокашлевые средства
антигеновусловно-патогенных - антигенов условно-патогенных
Тимьянаползучего - Тимьяна ползучего
+[Клавулановая - + [Клавулановая
условно-патогенныхмикроорганизмов - условно-патогенных микроорганизмов
микроорганизмовполикомпонентная - микроорганизмов поликомпонентная
поликомпонентнаямкг - поликомпонентная мкг
отхаркивающимисредствами - отхаркивающими средствами
широкогоспектра - широкого спектра
сотхаркивающими - с отхаркивающими
экстрактмл - экстракт мл
профилактикибактериальных инфекций - профилактики бактериальных инфекций
нарушениянадпочечников - нарушения надпочечников
нарушения,связанные - нарушения, связанные
гонадотропин-рилизинг - гонадотропин-рилизинг
Аналогигонадотропин-рилиз - Аналоги гонадотропин-рилиз
Минералокортикоиды - Минералокортикоиды
полусинтетическиеэстрогены - полусинтетические эстрогены
иполусинтетические - и полусинтетические
Производныепрегнадиена - Производные прегнадиена
Производные3-оксоандрост-4-ена - Производные 3-оксоандрост-4-ена
ингибиторамибета-лактамаз - ингибиторами бета-лактамаз
кислота]мг - кислота] мг
Инозин+Никотинамид+ - Инозин+Никотинамид +
Аминокапроноваякислота - Аминокапроновая кислота
заболеванийнервной - заболеваний нервной
Комбинациипенициллинов, - Комбинации пенициллинов,
[Клавулановаякислота] - [Клавулановая кислота]
Рибофлавин+Янтарнаякислота - Рибофлавин+Янтарная кислота
+мл - + мл
Натрияхлорид+Натрия - Натрия хлорид+Натрия
Декстроза+Калияхлорид+ - Декстроза+Калия хлорид+
Другиепротивокашлевые - Другие противокашлевые
Антигистаминныепрепараты - Антигистаминные препараты
[Калияхлорида-Кальция - [Калия хлорида-Кальция
кислотымг - кислоты мг
Имидазолилэтанамидпентандиовой - Имидазолилэтанамид пентандиовой
питанияг - питания г
Метилфенилтиометил-диметиламинометил-гидр - Метилфенилтиометил-диметиламинометил-гидр
кислотыэтиловый - кислоты этиловый
Амброксол+Натрияглицирризинат+Тимьяна - Амброксол+Натрия глицирризинат+Тимьяна
идезинфицирующие - и дезинфицирующие
Замещенныеэтилендиамины - Замещенные этилендиамины
иметиламинометил-гидроксиброминдол - иметиламинометил-гидроксиброминдол
хлорида-Кальцияхлорид+Натрия - хлорида-Кальция хлорид+Натрия
Ингибиторынейроаминидазы - Ингибиторы нейроаминидазы
Антибиотикигликопептидной структуры - Антибиотики гликопептидной структуры
оксиброминдолкарбоновой - оксиброминдол карбоновой
протеиназплазмы - протеиназ плазмы
наружногоприменения - наружного применения
травыэкстракт - травы экстракт
кислотаг - кислота г
акридонацетатмл - акридонацетат мл
[Сульбактам]мг - [Сульбактам] мг
лактат]мл - лактат] мл
Меглюминаакридонацетат - Меглюмина акридонацетат
протоновогонасоса - протонового насоса
кислотамл - кислота мл
глицирризинат+Тимьянаползучего - глицирризинат+Тимьяна ползучего
30000-40000]+Декстрозамл - 30000-40000]+Декстроза мл
[ср.мол.масса30000-40000]+Декстроза - [ср.мол.масса 30000-40000]+Декстроза
частотыпредоставления - частоты предоставления
/или - / или
иего - и его
показательчастоты - показатель частоты
Усредненныйпоказатель - Усредненный показатель
свитаминами - с витаминами
Стимуляторымоторики - Стимуляторы моторики
Производныепрегн-4-ена - Производные прегн-4-ена
(цианокобаламини - (цианокобаламин и
периферическогокровообращения - периферического кровообращения
костейтаза - костей таза
иноворожденного - и новорожденного
новорожденногонеуточненное - новорожденного неуточненное
,, - , ,
■! - ■ !
*терапевтическо- - * терапевтическо-
классификация! - классификация !
Производныегидантоина - Производные гидантоина
'химическая - ' химическая
Iчастоты - I частоты
■* - ■ *
Гидрокортизонмг 25 ̂ 1 2 5 .........., | ! - Гидрокортизон мг 25 ̂ 1 2 5 .........., | !
измерения - измерения
системныегемостатики - системные гемостатики
химическаяклассификация - химическая классификация
!! - ! !
ОД! - ОД !
Другие| - Другие |
!, - ! ,
аминогликозиды■ - аминогликозиды ■
С01СА! - С01СА !
зобо! - зобо !
бета-лактамазам - бета-лактамазам
гликопептидной; - гликопептидной ;
Производные! - Производные !
Ингибиторы, - Ингибиторы,
бензодиазепина■ - бензодиазепина ■
алкалоидыопия - алкалоиды опия
Ампициллинмг 300 101 - Ампициллин мг 300 101
Цефалоспорины! - Цефалоспорины !
•! - • !
*' - * '
;’ - ; ’
;! - ; !
предоставления! - предоставления !
,| - , |
АВ! - АВ !
Противовирусные' - Противовирусные '
карбоангидразы■ - карбоангидразы ■
*> - * >
предоставления, - предоставления,
!частоты - ! частоты
ния; - ния ;
-------------------, - ------------------- ,
препараты■ - препараты ■
'' - ' '
..........,| - .........., |
нитроимидазола■ - нитроимидазола ■
СР|1 - СР |1
]! - ] !
ния, - ния ,
Антагонисты, - Антагонисты,
Пенициллиныширокого - Пенициллины широкого
Цефалоспоринывторого - Цефалоспорины второго
|химическая - | химическая
Ацетазоламидмг : 150 2100 14 - Ацетазоламид мг : 150 2100 14
,■ - , ■
!терапевтическо- - ! терапевтическо-
дофаминергические• - дофаминергические •
Пенициллины,устойчивые - Пенициллины, устойчивые
растворы! - растворы !
измерениямг - измерения мг
Нозологическиеединицы - Нозологические единицы
детскоговозраста - детского возраста
Пиперазиновыепроизводные - Пиперазиновые производные
психостимуляторыи - психостимуляторы и
иоксепины - и оксепины
Диазепины,оксазепины, - Диазепины, оксазепины,
оксазепины,тиазепины - оксазепины, тиазепины
Производныефенотиазина - Производные фенотиазина
высокоосмолярныерентгеноконтрастные - высокоосмолярные рентгеноконтрастные
бариясульфат - бария сульфат
цыизмере - цы измере
таблетка - таблетка
низкоосмолярныерентгеноконтрастные средства - низкоосмолярные рентгеноконтрастные средства
Среднееколичество - Среднее количество
нефротропныенизкоосмолярные - нефротропные низкоосмолярные
слоемдоза 1 1 - слоем доза 1 1
частотыпредоставле - частоты предоставле
афереза,вирусинактивированная - афереза, вирусинактивированная
Гидроксиалюминиятрисульфофталоцианин - Гидроксиалюминия трисульфофталоцианин
трисульфофталоцианинмг - трисульфофталоцианин мг
количествочастоты - количество частоты
Водорастворимыенефротропные - Водорастворимые нефротропные
Единицы - Едини цы
нефротропныевысокоосмолярные - нефротропные высокоосмолярные
рентгеноконтрастныесредства - рентгеноконтрастные средства
перидинмг - перидин мг
ыйпоказатель - ый показатель
вирусинактивированнаядоза 3 3 5. - вирусинактивированная доза 3 3 5.
замедляющиерост - замедляющие рост
Усредненный - Усредненн ый
Пропионилфенилэтоксиэтилпиперидин - Пропионилфенилэтоксиэтилпиперидин
Рентгеноконтрастныесредства, - Рентгеноконтрастные средства,
углеводногосредство - углеводного средство
предоставления - предоставления
измереклассификация - измере классификация
ниясед*** - ния сед***
Производныеимидазола - Производные имидазола
Анатомо-терапевтическо- - Анатомо- терапевтическо-
терапевтическо-химическая - терапевтическо- химическая
низкоосмолярныерентгеноконтрастные - низкоосмолярные рентгеноконтрастные
бета-лактамаз - бета-лактамаз
Наименованиелекарственного - Наименование лекарственного
Иогексолмг 300 300 - Иогексол мг 300 300
екдтерапевтическо- - екд терапевтическо-
.....; - ..... ;
поколенияод - поколения од
од..... - од.....
цыхимическая - цы химическая
Электролитныерастворы - Электролитные растворы
Амоксициллин+[Клавулановаякислота] - Амоксициллин+[Клавулановая кислота]
Этанолмл 5 15 - Этанол мл 5 15
Цефалоспоринытретьего - Цефалоспорины третьего
цыхимическая классификация частоты предоставления измере ния 1 - цы химическая классификация частоты предоставления измере ния 1
гдеозначает, что данное мероприятие проводится 100% пациентов, соответствующих данной модели, а цифры менее 1 - указанному в стандарте медицинской помощи проценту пациентов, имеющих соответствующие медицинские показания. - где означает, что данное мероприятие проводится 100% пациентов, соответствующих данной модели, а цифры менее 1 - указанному в стандарте медицинской помощи проценту пациентов, имеющих соответствующие медицинские показания.
Ацетилсалициловаякислота - Ацетилсалициловая кислота
болезнижелудка - болезни желудка
Колониестимулирующиефакторы - Колониестимулирующие факторы
Ко-тримоксазол[Сульфаметоксазол - Ко-тримоксазол [Сульфаметоксазол
IgA]мг - IgA] мг
Изониазидмг 300 8400 - Изониазид мг 300 8400
Иммуноглобулиныспецифические - Иммуноглобулины специфические
факторанекроза - фактора некроза
низкойактивностью - низкой активностью
Триметоприм]мг - Триметоприм] мг
ингибиторовобратной транскриптазы - ингибиторов обратной транскриптазы
третьегопоколения - третьего поколения
+[Сульбактам] - + [Сульбактам]
нормальный[IgG - нормальный [IgG
Ингибиторыкальциневрина - Ингибиторы кальциневрина
альфа(ФНО-альфа) - альфа (ФНО-альфа)
протонногонасоса - протонного насоса
другимисредствами - другими средствами
механизмомдействия - механизмом действия
Бензодиазепиноподобные - Бензодиазепиноподобные
Блокаторысеротониновых - Блокаторы серотониновых
Противомикробныепрепараты - Противомикробные препараты
Имипенем+[Циластатин] - Имипенем+[Циластати н]
барвинкаи - барвинка и
Производныесульфонилмочевины - Производные сульфонилмочевины
Опиоидныеанальгетики - Опиоидные анальгетики
препаратысистемного - препараты системного
иродственные соединения - и родственные соединения
Н2-гистаминовыхрецепторов - Н2-гистаминовых рецепторов
комбинациис - комбинации с
антибактериальныепрепараты - антибактериальные препараты
иханалоги - их аналоги
противовоспалительные - противовоспалительные
снижающиемоторику - снижающие моторику
Нестероидныепротивовоспалительн - Нестероидные противовоспалительн
4-гопоколения - 4-го поколения
короткогодействия - короткого действия
Другиеантианемические - Другие антианемические
Производныеподофиллотоксина - Производные подофиллотоксина
иантисептики - и антисептики
Гликозидынаперстянки - Гликозиды наперстянки
альфа-2bмкг - альфа-2b мкг
Ингибиторыобразования - Ингибиторы образования
кромеингибиторов обратной транскриптазы - кроме ингибиторов обратной транскриптазы
кислотаи - кислота и
серотониновых5НТЗ-рецепторов - серотониновых 5НТЗ-рецепторов
Осмотическиеслабительные - Осмотические слабительные
Другиепротивогрибковые - Другие противогрибковые
Ингибиторыпротеинкиназы - Ингибиторы протеинкиназы
н]мг - н] мг
Препараты,снижающие - Препараты, снижающие
-ингибиторы - - ингибиторы
антианемическиепрепараты - антианемические препараты
мочевойкислоты - мочевой кислоты
Пэгинтерферональфа-2а - Пэгинтерферон альфа-2а
инуклеотиды - и нуклеотиды
инъекционноговведения - инъекционного введения
противоопухолевыепрепараты - противоопухолевые препараты
Прочиепротивоопухолевые - Прочие противоопухолевые
Дексаметазонмкг 500 5000 - Дексаметазон мкг 500 5000
дляместного - для местного
полостирта - полости рта
Пэгинтерферональфа-2b - Пэгинтерферон альфа-2b
Прокаинмг 25 600 гепариноиды для местного применения - Прокаин мг 25 600 гепариноиды для местного применения
дляинъекционного - для инъекционного
там]мг - там] мг
Прочиеантибактериальные - Прочие антибактериальные
Противогрибковыеантибиотики - Противогрибковые антибиотики
альфа-2амкг - альфа-2а мкг
спектрадействия - спектра действия
полимальтозатмг - полимальтозат мг
иамидины - и амидины
Алкалоидыспорыньи - Алкалоиды спорыньи
Цефалоспорины4-го - Цефалоспорины 4-го
кислотыи - кислоты и
Цефалоспорины1-го - Цефалоспорины 1-го
Альфа-адреноблокаторы - Альфа-адреноблокаторы
Цефалоспорины3-го - Цефалоспорины 3-го
общейанестезии - общей анестезии
+кислота] - + кислота]
аямг - ая мг
двухфазный[человеческий - двухфазный [человеческий
кромеинсулинов - кроме инсулинов
аспартдвухфазный - аспарт двухфазный
лизпродвухфазный - лизпро двухфазный
вкомбинации с инсулинами короткого действия для инъекционного введения - в комбинации с инсулинами короткого действия для инъекционного введения
ибета-адреноблокаторы - и бета-адреноблокаторы
уксуснойкислоты и родственные соединения - уксусной кислоты и родственные соединения
среднейпродолжительности - средней продолжительности
Гормоны,расщепляющие - Гормоны, расщепляющие
Другиегипогликемические - Другие гипогликемические
противоэпилептическиепрепараты - противоэпилептические препараты
Инсулин-изофан[человеческий - Инсулин-изофан [человеческий
аналогидля - аналоги для
продолжительностидействия - продолжительности действия
длительногодействия - длительного действия
]мг - ] мг
гипогликемическиепрепараты, - гипогликемические препараты,
Ингибиторыальфа-глюкозидазы - Ингибиторы альфа-глюкозидазы
Другиепротивоэпилептические - Другие противоэпилептические
Ингибиторыдипептидилпептидазы-4 - Ингибиторы дипептидилпептидазы-4
срадикулопатией - с радикулопатией
Бензодиазепиноподобныесредства - Бензодиазепиноподобные средства
[Лидокаин]мл - [Лидокаин] мл
лечениязаболеваний желудочно-кишечного тракта и нарушений обмена веществ - лечения заболеваний желудочно-кишечного тракта и нарушений обмена веществ
Грибкикапсул - Грибки капсул
препаратыплазмы - препараты плазмы
кишечныепрепараты - кишечные препараты
действияи - действия и
(полипазе) - (по липазе)
Натрияацетат - Натрия ацетат
капсула - капсула
наводно-электролитный баланс - на водно-электролитный баланс
фециумтаблет - фециум таблет
Лактобактерииацидофильные - Лактобактерии ацидофильные
Лизоцимдоза - Лизоцим доза
заболеванийжелчевыводящих - заболеваний желчевыводящих
желчныхкислот - желчных кислот
желчевыводящихпутей - желчевыводящих путей
экстрактмг - экстракт мг
пятнистойплодов - пятнистой плодов
гдеозначает, что данное мероприятие проводится 100% пациентов, соответствующих данной модели, а цифры менее 1 - указанному в стандарте медицинской помощи проценту пациентов, имеющих соответствующие медицинские показания. - где означает, что данное мероприятие проводится 100% пациентов, соответствующих данной модели, а цифры менее 1 - указанному в стандарте медицинской помощи проценту пациентов, имеющих соответствующие медицинские показания.
гдеозначает, что данное мероприятие проводится 100% пациентов, соответствующих данной модели, а цифры менее 1 - указанному в стандарте медицинской помощи проценту пациентов, имеющих соответствующие медицинские показания. - где означает, что данное мероприятие проводится 100% пациентов, соответствующих данной модели, а цифры менее 1 - указанному в стандарте медицинской помощи проценту пациентов, имеющих соответствующие медицинские показания.
гдеозначает, что данное мероприятие проводится 100% пациентов, соответствующих данной модели, а цифры менее 1 - указанному в стандарте медицинской помощи проценту пациентов, имеющих соответствующие медицинские показания. - где означает, что данное мероприятие проводится 100% пациентов, соответствующих данной модели, а цифры менее 1 - указанному в стандарте медицинской помощи проценту пациентов, имеющих соответствующие медицинские показания.
путейнеуточненная - путей неуточненная
гидроксидасахарозный - гидроксида сахарозный
комплексмг - комплекс мг
Парентеральныепрепараты - Парентеральные препараты
Производныенитроимидазола - Производные нитроимидазола
Инозин+Никотинамид+Рибофлавин+Янтарная - Инозин+Никотинамид+Рибофла вин+Янтарная
угольмг 10000 50000 - уголь мг 10000 50000
Омепразолмг 20 200 - Омепразол мг 20 200
неклассифицированные - не классифицированные
дляустранения - для устранения
четвертичныеаммониевые - четвертичные аммониевые
дофаминергические - дофаминергические
Другиеантисептики - Другие антисептики
Глицерол]мл - Глицерол] мл
Производныехолина - Производные холина
среднейпродолжительност - средней продолжительност
Другиеминеральные - Другие минеральные
Другиечетвертичные - Другие четвертичные
Галогенированныеуглеводороды - Галогенированные углеводороды
Селективныебета-адреноблокат - Селективные бета-адреноблокат
продолжительности - продолжительности
Изосорбидамононитрат - Изосорбида мононитрат
аммониевыесоединения - аммониевые соединения
мононитратмг - мононитрат мг
Эфирыалкиламинов - Эфиры алкиламинов
Местныеанестетики - Местные анестетики
Препаратыкальция - Препараты кальция
идофаминергически - и дофаминергически
1275+4,418500+ - 1275+4,4 18500+
158+1275+4,4 - 158+ 1275+4,4
18500+127500+ - 18500+ 127500+
Колекальциферолмг+МЕ - Колекальциферол мг+МЕ
Железосвязывающиепрепараты - Железосвязывающие препараты
ибета-адреноблокатор - и бета-адреноблокатор
Селективныебета-адреноблокатор - Селективные бета-адреноблокатор
полимальтозатг - полимальтозат г
жирныхкислот - жирных кислот
препаратымг - препараты мг
итриметоприма, включая производные - и триметоприма, включая производные
питанияи - питания и
Цианокобаламинмл - Цианокобаламин мл
+[Метилцеллюлоза] - + [Метилцеллюлоза]
Бутиламиногидроксипропоксифеноксиметил - Бутиламиногидроксипропоксифеноксиметил
сульфатмл - сульфат мл
[Метилцеллюлоза]мг - [Метилцеллюлоза] мг
метилоксадиазолмг - метилоксадиазол мг
Цинкасульфат - Цинка сульфат
вофтальмологии - в офтальмологии
противомикробнымисредствами - противомикробными средствами
противоглаукомныепрепараты - противоглаукомные препараты
Смл - С мл
Клонидинмг - Клонидин мг
но-пропиламмониймг - но-пропиламмоний мг
препараты,применяемые - препараты, применяемые
Метионил-глутамил-гистидил-фенилаланил-пролил-глицил-п - Метионил-глутамил-гистидил- фенилаланил-пролил-глицил-п
Бензилдиметил-миристоиламино-пропиламмоний - Бензилдиметил-миристоиламино-пропиламмоний
феноксиметилметилоксадиазол - феноксиметил метилоксадиазол
ролинмг - ролин мг
Гипромеллозамл - Гипромеллоза мл
фенилаланил-пролил-глицил-пролин - фенилаланил-пролил-глицил-п ролин
спротивомикробными - с противомикробными
происхождения,связанное - происхождения, связанное
устройством,фиксирующим - устройством, фиксирующим
внутреннимиортопедическими - внутренними ортопедическими
ортопедическогоимплантата - ортопедического имплантата
устройствами,имплантатами - устройствами, имплантатами
костнойпластинки - костной пластинки
реакция,обусловленные - реакция, обусловленные
инеуточненных - и неуточненных
днаполости - дна полости
основанияязыка - основания языка
Водорастворимыенефротропные низкоосмолярные рентгеноконтрастные средства - Водорастворимые нефротропные низкоосмолярные рентгеноконтрастные средства
трехраздельнойтрава+Шиповника - трехраздельной трава+Шиповника
вурологии - в урологии
[Escherichiacoli] - [Escherichia coli]
листья+Чередытрехраздельной - листья+Череды трехраздельной
Спазмолитики,применяемые - Спазмолитики, применяемые
продырявленноготрава+Толокнянки - продырявленного трава+Толокнянки
coli]мг - coli] мг
трава+Толокнянкиобыкновенной - трава+Толокнянки обыкновенной
илигепариноиды - или гепариноиды
Производныенитрофурана - Производные нитрофурана
плодымл - плоды мл
влагалищнойоболочки - влагалищной оболочки
тестостерон-5-альфа-редуктазы - тестостерон-5-альфа-редуктазы
Ингибиторытестостерон-5-альфа - Ингибиторы тестостерон-5-альфа
неклассифицированная - не классифицированная
Антихолинэстеразные - Антихолинэстеразные
препаратыдвухвалентного - препараты двухвалентного
человеческийальфа-2 - человеческий альфа-2
противоаллергическиесредства - противоаллергические средства
дифенгидраминмл - дифенгидрамин мл
метилоксадиазол+Клонидинмг - метилоксадиазол+Клонидин мг
длянаружного применения - для наружного применения
Бензалконияхлорид+Гипромеллоза - Бензалкония хлорид+Гипромеллоза
Бензилдиметил-миристоиламинопропиламмоний - Бензилдиметил-миристоилами нопропиламмоний
Бутиламиногидроксипропокси- - Бутиламиногидроксипропокси -
кислота+Цинкасульфат - кислота+Цинка сульфат
хлорид+Гипромеллозамл - хлорид+Гипромеллоза мл
нопропиламмониймг - нопропиламмоний мг
Другиепротивоаллергические - Другие противоаллергические
феноксиметилметилоксадиазол+Клонидин - феноксиметил метилоксадиазол+Клонидин
Противолепрозныепрепараты - Противолепрозные препараты
высокойактивностью - высокой активностью
илипотропные - и липотропные
антибиотикидля - антибиотики для
свысокой - с высокой
липотропныесредства - липотропные средства
идинмг - идин мг
палочкидоза - палочки доза
средстваод - средства од
дляпротивоопухолевой - для противоопухолевой
серотониновых5НТ3-рецепторов - серотониновых 5НТ3-рецепторов
Дезинтоксикационныепрепараты - Дезинтоксикационные препараты
имягких - и мягких
ибрюшины - и брюшины
+мг - + мг
почки,кроме - почки, кроме
питания+ - питания +
Дезинтоксикационныепрепараты для противоопухолевой терапии - Дезинтоксикационные препараты для противоопухолевой терапии
преимущественнокарликовостью - преимущественно карликовостью
iso(Xq) - iso (Xq)
ипозвоночного - и позвоночного
аномальнойполовой - аномальной половой
другихрубриках - других рубриках
щитовиднойжелезы - щитовидной железы
имидазолиновыхрецепторов - имидазолиновых рецепторов
полимальтозатмл - полимальтозат мл
нияния - ния ния
листьевэкстракт - листьев экстракт
кислота+Цистинмг - кислота+Цистин мг
Другиеантиаритмические - Другие антиаритмические
кардиотоническиесредства - кардиотонические средства
четвертичныеаммониевые соединения - четвертичные аммониевые соединения
антиаритмическиепрепараты - антиаритмические препараты
комбинированныепрепараты - комбинированные препараты
Другиекардиотонические - Другие кардиотонические
антигипертензивныесредства - антигипертензивные средства
иноотропные препараты - и ноотропные препараты
кислота+Клопидогрелмг - кислота+Клопидогрел мг
Ацетилсалициловаякислота+Клопидогрел - Ацетилсалициловая кислота+Клопидогрел
местногоприменения - местного применения
1-гопоколения - 1-го поколения
Прочиекомбинированные - Прочие комбинированные
Глицин+Глутаминоваякислота+Цистин - Глицин+Глутаминовая кислота+Цистин
Другиеантигипертензивные - Другие антигипертензивные
комбинированныепрепараты для лечения заболеваний сердца - комбинированные препараты для лечения заболеваний сердца
третичныеамины - третичные амины
Производныефенил-алкиламина - Производные фенил-алкиламина
Клопидогрелмг - Клопидогрел мг
Цистинмг - Цистин мг
кислота+ - кислота +
Ингибиторыпротеиназ - Ингибиторы протеиназ
Синтетическиеантихолинергически - Синтетические антихолинергически
заболеванийсердца - заболеваний сердца
моторикижелудочно-кишечног - моторики желудочно-кишечног
антихолинергические - антихолинергические
Другиепротивоэпилептичес - Другие противоэпилептичес
противоэпилептические - противоэпилептические
Производныесукцинимида - Производные сукцинимида
умереннойдепрессии - умеренной депрессии
безпсихотических - без психотических
итиазепины - и тиазепины
фенилдигидробенздиазепинмг - фенилдигидробенздиазепин мг
пирролидонмг - пирролидон мг
головногомозга - головного мозга
Гидразинокарбонилметилбромфенилдигидробенздиазепин - Гидразинокарбонилметилбромфенилдигидробенздиазепин
иазепинмг - иазепин мг
скотамг - скота мг
дерматологическиепрепараты - дерматологические препараты
Соединенияалюминия - Соединения алюминия
Производныеандростана - Производные андростана
Прочиедерматологические - Прочие дерматологические
гидролизатмл - гидролизат мл
иих - и их
скотагидролизат - скота гидролизат
парасимпатомиметики - парасимпатомиметики
Никотиноваякислота - Никотиновая кислота
Производныеэстрена - Производные эстрена
Другиепарасимпатомимет - Другие парасимпатомимет
Другиевитаминные - Другие витаминные
церебральныеишемические - церебральные ишемические
Ингибиторытромбина - Ингибиторы тромбина
Прочиеантикоагулянты - Прочие антикоагулянты
кислота+Дипиридамолмг - кислота+Дипиридамол мг
дляустранения головокружения - для устранения головокружения
Ацетилсалициловаякислота+Дипиридамол - Ацетилсалициловая кислота+Дипиридамол
Ацетилсалициловаякислота+Магния - Ацетилсалициловая кислота+Магния
гидроксидмг - гидроксид мг
простымипарциальными - простыми парциальными
идиопатическаяэпилепсия - идиопатическая эпилепсия
неуточненныебез - неуточненные без
судорожнымиприпадками - судорожными припадками
(парциальная)симптоматическая - (парциальная) симптоматическая
иэпилептические - и эпилептические
(парциальная)идиопатическая - (парциальная) идиопатическая
(смалыми - (с малыми
комплекснымипарциальными - комплексными парциальными
эпилепсиии - эпилепсии и
нормальныймл - нормальный мл
ынормальные - ы нормальные
Другиепротивоэпилептич - Другие противоэпилептич
Адренокортикотропный - Адренокортикотропный
гормон(АКТГ) - гормон (АКТГ)
Иммуноглобулины - Иммуноглобулины
идвигательные - и двигательные
нарушенияпри - нарушения при
расстройствонеуточненное - расстройство неуточненное
идругие - и другие
агонистысеротониновых - агонисты серотониновых
серотониновых5НТ1-рецепторов - серотониновых 5НТ1-рецепторов
гамма-аминомаслянаякислота - гамма-аминомасляная кислота
Селективныеагонисты - Селективные агонисты
Другиепротивоэпилептически - Другие противоэпилептически
обратногозахвата - обратного захвата
ролидонмг - ролидон мг
Производныенитроферрицианида - Производные нитроферрицианида
Другиеантигистаминные средства системного действия - Другие антигистаминные средства системного действия
гистаминовыхрецепторов - гистаминовых рецепторов
функциональныхнарушений - функциональных нарушений
ГМГ-КоА-редуктазы - ГМГ-КоА-редуктазы
тромбинапрямые - тромбина прямые
Янтарнаякислота - Янтарная кислота
Дипиридамолмг - Дипиридамол мг
фенилалкиламина - фенилалкиламина
H2-гистаминовыхрецепторов - H2-гистаминовых рецепторов
2-гопоколения - 2-го поколения
длягемодиализа - для гемодиализа
гемодиализа(концентраты) - гемодиализа (концентраты)
-го#поколения - -го# поколения
Пероральныепрепараты трехвалентного железа - Пероральные препараты трехвалентного железа
болезниполового - болезни полового
ипарафимоз - и парафимоз
Нестероидныепротивовоспалитель - Нестероидные противовоспалитель
ифаринготонзиллит - и фаринготонзиллит
сантибиотиками - с антибиотиками
леченияугревой - лечения угревой
итриазола - и триазола
Неомицинг - Неомицин г
неуточненнойлокализации - неуточненной локализации
Метилфенилтиометил-диметиламинометил-гидроксиброминдол - Метилфенилтиометил-диметиламинометил-гидроксиброминдол
обструктивныхзаболеваний - обструктивных заболеваний
экстракт! - экстракт !
Отхаркивающиепрепараты - Отхаркивающие препараты
заболеванийдыхательных - заболеваний дыхательных
ползучеготравы - ползучего травы
ометил-гидроксиброминдолкарбоновой - ометил-гидроксиброминдол карбоновой
средствасистемного - средства системного
Диазепины,оксазепины - Диазепины, оксазепины
мелатониновыхрецепторов - мелатониновых рецепторов
Агонистымелатониновых - Агонисты мелатониновых
Неселективныебета-адреноблокатор ы - Неселективные бета-адреноблокатор ы
дофаминовыхрецепторов - дофаминовых рецепторов
лечениядеменции - лечения деменции
моноаминоксидазытипа - моноаминоксидазы типа
инарушений - и нарушений
Агонистыдофаминовых - Агонисты дофаминовых
Производныеадамантана - Производные адамантана
заболеванийжелудочно-кишечно - заболеваний желудочно-кишечно
кбета-лактамазам - к бета-лактамазам
А-гемагглютинин - А- гемагглютинин
Ингибиторымоноаминоксидазы - Ингибиторы моноаминоксидазы
предоставленияизмере - предоставления измере
Неостигминаметилсульфат - Неостигмина метилсульфат
ингибиторыобратного захвата серотонина - ингибиторы обратного захвата серотонина
оболочкоймг - оболочкой мг
Пиридоксинмг - Пиридоксин мг
покрытыеоболочкой - покрытые оболочкой
Никотинамид+ - Никотинамид +
Метилкобаламинатаблетки - Метилкобаламина таблетки
метилсульфатмг - метилсульфат мг
+[Лидокаин] - + [Лидокаин]
способствующиенормальному - способствующие нормальному
0,1+0,004+1 - 0,1+ 0,004+1
азоксимерабромидом - азоксимера бромидом
экстрактг - экстракт г
Протеолитическиеферменты - Протеолитические ферменты
препараты,способствующие - препараты, способствующие
нормальномурубцеванию - нормальному рубцеванию
Ферментныепрепараты - Ферментные препараты
луковицэкстракт - луковиц экстракт
0,004+11+0,04+10 - 0,004+1 1+0,04+10
водно-электролитный - водно-электролитный
наводно-электролитн - на водно-электролитн
эфирыс - эфиры с
Синтетическиеантихолинергическ - Синтетические антихолинергическ
Растворы,влияющие - Растворы, влияющие
липазе)(по - липазе) (по
кефирныемлн. - кефирные млн.
наводно-электролитны - на водно-электролитны
умереннойактивностью - умеренной активностью
Е10+10+ - Е 10+10+
сумеренной - с умеренной
нмг - н мг
Неомицинмг+мг+М - Неомицин мг+мг+М
+Ретинолмг - +Ретинол мг
Диоксометилтетрагидропиримидин - Диоксометилтетрагидропиримидин
Прочиепротивогрибковые - Прочие противогрибковые
активностьюв - активностью в
Метилпреднизолонмг 12 4380 - Метилпреднизолон мг 12 4380
Комбинациипенициллинов, включая комбинации с ингибиторами бета-лактамаз - Комбинации пенициллинов, включая комбинации с ингибиторами бета-лактамаз
палочкидоз - палочки доз
ингибиторыобратной - ингибиторы обратной
другимипсихоактивными - другими психоактивными
енил-2-пирролидонмг - енил-2-пирролидон мг
300+50+25+5 - 300+50 +25+5
Пиперазиновыепроизводные фенотиазина - Пиперазиновые производные фенотиазина
18000+3000+ - 18000+ 3000+
+25+518000+ - +25+5 18000+
3000+1500+30 - 3000+ 1500+30
двулопастноголистьев - двулопастного листьев
несколькообластей - несколько областей
сложный[Калия - сложный [Калия
питания+Прочиепрепараты - питания+Прочие препараты
[Поливитамины]мл - [Поливитамины] мл
(5) - ( 5)
Производныеорипавина - Производные орипавина
моторикужелудочно-кишечного - моторику желудочно-кишечного
сосмешанным механизмом действия - со смешанным механизмом действия
Селективныебета2-адреномиметики - Селективные бета2-адреномиметики
другимипрепаратами - другими препаратами
Прочиепрепараты - Прочие препараты
стероиднойструктуры - стероидной структуры
инсулинамикороткого - инсулинами короткого
Инсулиныдлительного - Инсулины длительного
дипептидилпептидазы-4 - дипептидилпептидазы-4
расщепляющиегликоген - расщепляющие гликоген
гопоколения - го поколения
Ингибиторыдипептидилпептидаз - Ингибиторы дипептидилпептидаз
действиядля - действия для
синсулинами - с инсулинами
ксиметилметилоксадиазол+Клонидин - ксиметил метилоксадиазол+Клонидин
противоопухолевыеантибиотики - противоопухолевые антибиотики
Бутиламиногидроксипропоксифено - Бутиламиногидроксипропок сифено
ксиметилметилоксадиазол - ксиметил метилоксадиазол
мино-пропиламмониймг - мино-пропиламмоний мг
метилоксадиазол+Клонидинмл - метилоксадиазол+Клонидин мл
Бета-адреноблокаторы - Бета-адреноблокаторы
Аналогипростагландинов - Аналоги простагландинов
Нестероидныепротивовоспалительны - Нестероидные противовоспалительны
Пилокарпин+[Метилцеллюлоза] - Пилокарпин+ [Метилцеллюлоза]
Другиепротивоопухолевые - Другие противоопухолевые
[Метилцеллюлоза]мл - [Метилцеллюлоза] мл
Другиепротивоглаукомные - Другие противоглаукомные
илисвиней - или свиней
свинеймг - свиней мг
глазкрупного - глаз крупного
угревойсыпи - угревой сыпи
Гидрокортизон+Фузидоваякислота - Гидрокортизон+Фузидовая кислота
Неомицинмг - Неомицин мг
Фузидоваякислота - Фузидовая кислота
Комбинациивитаминов - Комбинации витаминов
Окситетрациклинмг - Окситетрациклин мг
Ретинолмг - Ретинол мг
Осмотическиеслабительные средства - Осмотические слабительные средства
А-гемагглютининкомплекс - А-гемагглютинин комплекс
Ботулиническийнейротоксин - Ботулинический нейротоксин
токсинтипа - токсин типа
14400+360[Карбидопа] - 14400+360 [Карбидопа]
Диэтиламинопропионилэтоксикарбониламинофенотиазин - Диэтиламинопропионилэтоксикарбониламинофенотиазин
антисептикидля - антисептики для
Димеркаптопропансульфонатнатрия - Димеркаптопропансульфонат натрия
карбониламинофенотиазинмг - карбониламинофенотиазин мг
Метамизолнатрия+ - Метамизол натрия+
натрия+Парацетамол+Фенобарбитал - натрия+Парацетамол+Фенобарбита л
Кодеин+Кофеин+Метамизолнатрия+Фенобарбитал - Кодеин+Кофеин+Метамизол натрия+Фенобарбитал
Кодеин+Кофеин+Метамизолнатрия+Парацетамол+Фенобарбита - Кодеин+Кофеин+Метамизол натрия+Парацетамол+Фенобарбита
лекарственнымисредствами, - лекарственными средствами,
внешнимиагентами - внешними агентами
неуточненнойорганической - неуточненной органической
органическойпылью - органической пылью
вызванныелекарственными - вызванные лекарственными
уточненнымивнешними - уточненными внешними
бета2-адреномиметики - бета2-адреномиметики
Сальбутамолмл - Сальбутамол мл
Фенотеролдоз - Фенотерол доз
Противоаллергическиесредства, - Противоаллергические средства,
другихсредств - других средств
кромеглюкокортикоидов - кроме глюкокортикоидов
леченияобструктивных - лечения обструктивных
еридинмг - еридин мг
Фенотеролмл - Фенотерол мл
глицинатацетилцистеинат - глицинат ацетилцистеинат
ацетилцистеинатмг - ацетилцистеинат мг
дыхательныхпутей - дыхательных путей
Комбинацииадренергических - Комбинации адренергических
Алгелдрат+Бензокаин+Магниягидроксид - Алгелдрат+Бензокаин+Магния гидроксид
гидроксид+Симетиконмл - гидроксид+Симетикон мл
светрогонными - с ветрогонными
другихкомбинациях - других комбинациях
леченияязвенной - лечения язвенной
идвенадцатиперстной кишки и гастроэзофагальной рефлюксной болезни - и двенадцатиперстной кишки и гастроэзофагальной рефлюксной болезни
гидроксидмл - гидроксид мл
моторикижелудочно-кишечно - моторики желудочно-кишечно
Алгелдрат+Магниягидроксид+Симетикон - Алгелдрат+Магния гидроксид+Симетикон
ветрогоннымисредствами - ветрогонными средствами
исуставных - и суставных
сочень - с очень
примышечных - при мышечных
оченьвысокой - очень высокой
мг+ - мг +
Клотримазолмг - Клотримазол мг
гидролизныймг - гидролизный мг
наводноэлектролитный - на водноэлектролитный
Лигнингидролизный - Лигнин гидролизный
Окситетрациклинмл - Окситетрациклин мл
имидазолмг - имидазол мг
леченияатопического - лечения атопического
дерматита,кроме - дерматита, кроме
Морфолиноэтилтиоэтоксибензимидазол - Морфолиноэтилтиоэтоксибензимидазол
тиосульфатмл 10 100 - тиосульфат мл 10 100
Клобетазолмг 10 50 - Клобетазол мг 10 50
бензимидазолмг - бензимидазол мг
Морфолиноэтилтиоэтокси-бензимидазол - Морфолиноэтилтиоэтокси- бензимидазол
Натамицин+ - Натамицин +
антигистаминныесредства системного действия - антигистаминные средства системного действия
хлоридмл 400 2000 - хлорид мл 400 2000
сумеренной активностью (группа - с умеренной активностью (группа
Неомицинмг+мг+ - Неомицин мг+мг+
ЕД10+10+350 - ЕД 10+10+350
бромидомконъюгат - бромидом конъюгат
сазоксимера - с азоксимера
суставныхболях - суставных болях
Метилпреднизолонаацепонат - Метилпреднизолона ацепонат
ацепонатмг - ацепонат мг
карбонат+Колекальциферолмг+МЕ - карбонат+Колекальциферол мг+МЕ
Кальциякарбонат+Колекальциферол - Кальция карбонат+Колекальциферол
Преднизолонмг 30 90 - Преднизолон мг 30 90
свысокой активностью в комбинации с другими средствами - с высокой активностью в комбинации с другими средствами
фурокумаринымг - фурокумарины мг
Псораленысистемного действия - Псоралены системного действия
плодовфурокумарины - плодов фурокумарины
киламинов - кил аминов
Триамцинолонмл - Триамцинолон мл
вкомбинации с другими средствами - в комбинации с другими средствами
лекарственногопрепарата*(3) - лекарственного препарата*(3)
еско-химическаяклассификация - еско-химическая классификация
Анатомо-терапевтическо-химическая - Анатомо-терапевтич еско-химическая
[Салициловаякислота] - [Салициловая кислота]
ыизмерен - ы измерен
Антигистаминныепрепараты для наружного применения - Антигистаминные препараты для наружного применения
антисептикидезинфицирующие - антисептики дезинфицирующие
высокойактивностью в комбинации с другими средствами - высокой активностью в комбинации с другими средствами
хлорида-Натрияхлорид+Натрия - хлорида-Натрия хлорид+Натрия
кишечныепротивомикробные - кишечные противомикробные
содержащиебария - содержащие бария
Пропионилфенилэтокси-этилпиперидин - Пропионилфенилэтокси-эт илпиперидин
кишечноготракта - кишечного тракта
Хлоргексидинмг 250+10 1000+40 - Хлоргексидин мг 250+10 1000+40
илпиперидинмг - илпиперидин мг
низкоосмолярныерентгеноконтрастны - низкоосмолярные рентгеноконтрастны
рентгеноконтрастные - рентгеноконтрастные
псориазадля - псориаза для
человека[ВИЧ] - человека [ВИЧ]
видеинфекционных - виде инфекционных
видедругих - виде других
видезлокачественных - виде злокачественных
Ненуклеозидныеингибиторы - Ненуклеозидные ингибиторы
Другиепротивотуберкулезные - Другие противотуберкулезные
бактерий[Туберкулезный - бактерий [Туберкулезный
[Туберкулезныйрекомбинантный] - [Туберкулезный рекомбинантный]
рекомбинантный]мл - рекомбинантный] мл
противотуберкулезныепрепараты - противотуберкулезные препараты
Антиингибиторныйкоагулянтный - Антиингибиторный коагулянтный
Факторысвертывания - Факторы свертывания
фиксированныекомбинации - фиксированные комбинации
эстрогены,фиксированные - эстрогены, фиксированные
свертываниякрови - свертывания крови
Синтетическиестимуляторы - Синтетические стимуляторы
Гонадотропинхорионический - Гонадотропин хорионический
гонадотропин-рилизинггормона - гонадотропин-рилизинг гормона
Аналогигонадотропин-рилизинг - Аналоги гонадотропин-рилизинг
Гормоныщитовидной - Гормоны щитовидной
стимуляторыовуляции - стимуляторы овуляции
иполусинтетические эстрогены - и полусинтетические эстрогены
Памидроноваякислота - Памидроновая кислота
Алендроноваякислота - Алендроновая кислота
Золедроноваякислота - Золедроновая кислота
Ибандроноваякислота - Ибандроновая кислота
длялечения заболеваний желудочно-кишечного тракта и нарушений обмена веществ - для лечения заболеваний желудочно-кишечного тракта и нарушений обмена веществ
локализацийголовного - локализаций головного
иболее - и более
Стандартпервичной - Стандарт первичной
5НТЗ-рецепторов - 5НТЗ -рецепторов
миорелаксантыпериферического действия - миорелаксанты периферического действия
скомплексными - с комплексными
спростыми - с простыми
Другиепротивоэпилептическ - Другие противоэпилептическ
илибез - или без
эпилептическиесиндромы - эпилептические синдромы
N-карбамоилметил-4-фенил-2-1-пирролидон - N-карбамоилметил-4-фенил-2-1- пирролидон
малымиприпадками - малыми припадками
иэпилептических - и эпилептических
безприпадков - без припадков
Фенилэфринмл - Фенилэфрин мл
другимисредствами, - другими средствами,
Блокаторылейкотриеновых - Блокаторы лейкотриеновых
кромекортикостероидов - кроме кортикостероидов
лейкотриеновыхрецепторов - лейкотриеновых рецепторов
назальныепрепараты - назальные препараты
профилактикибактериальных - профилактики бактериальных
слизисто-гнойныйхронический - слизисто-гнойный хронический
илихронический - или хронический
Морфолиноэтилтиоэтоксибензи-мидазол - Морфолиноэтилтиоэтоксибен зи-мидазол
зи-мидазолмг - зи-мидазол мг
приникотиновой - при никотиновой
Препараты,применяемые - Препараты, применяемые
никотиновойзависимости - никотиновой зависимости
бромид+Фенотеролдоза - бромид+Фенотерол доза
Антихолинерги-ческие - Антихолинерги-чески е
Тетраметилтетраазабициклоок-тандион - Тетраметилтетраазабициклоо к-тандион
к-тандионг - к-тандион г
Ипратропиябромид+Фенотерол - Ипратропия бромид+Фенотерол
Метионил-глутамил-гистидил-фенилаланил-проли - Метионил-глутамил-гист идил-фенилаланил-проли
корыголовного - коры головного
скотамл - скота мл
идил-фенилаланил-пролил-глицил-пролин - идил-фенилаланил-проли л-глицил-пролин
л-глицил-пролинмкг - л-глицил-пролин мкг
кишечноготракта и нарушений обмена веществ - кишечного тракта и нарушений обмена веществ
Производныепропионовой кислоты - Производные пропионовой кислоты
кишечного тракта - кишечног о тракта
Производныежирных кислот - Производные жирных кислот
Бензилдиметилмиристоиламинопропиламмоний - Бензилдиметилмиристоилами нопропиламмоний
сосмягчающим - со смягчающим
Клонидинмл - Клонидин мл
защитнымдействием - защитным действием
Бетаметазон+[Салициловая - Бетаметазон+ [Салициловая
Прочиедерматологические препараты - Прочие дерматологические препараты
новообразованиюсосудов - новообразованию сосудов
веносклерозирующие - веносклерозирующи е
снижающиепроницаемость - снижающие проницаемость
борнойкислоты - борной кислоты
Средства,препятствующие - Средства, препятствующие
препаратыдля лечения заболеваний нервной системы - препараты для лечения заболеваний нервной системы
Симпатомиметикидля - Симпатомиметики для
лечениязаболеваний желудочно-кишечно го тракта и нарушений обмена веществ - лечения заболеваний желудочно-кишечно го тракта и нарушений обмена веществ
Цианокобаламинмг - Цианокобаламин мг
антибиотикидля наружного применения - антибиотики для наружного применения
Другиевеносклерозирующи - Другие веносклерозирующи
леченияглаукомы - лечения глаукомы
противомикробныепрепараты и антисептики - противомикробные препараты и антисептики
рогатогоскота - рогатого скота
сетчаткиглаз - сетчатки глаз
предоставленияизмерения - предоставления измерения
препарата*(3)показатель - препарата*(3) показатель
ко-химическаяклассификация - ко-химическая классификация
классификациялекарственного - классификация лекарственного
коже,вызванное - коже, вызванное
имедикаментами - и медикаментами
другимивеществами, - другими веществами,
неуточненнымивеществами, - неуточненными веществами,
приемомлекарственных - приемом лекарственных
Производныеимидазола и триазола - Производные имидазола и триазола
Гидрокортизон+Фузидовая - Гидрокортизон+Фу зидовая
тамицин+Неомицин - тамицин+Неомици н
Гидрокортизон+Натамицин+Неомици - Гидрокортизон+На тамицин+Неомици
Амидымл - Амиды мл
сыпидля - сыпи для
примененияпри - применения при
фолиевойкислотой - фолиевой кислотой
Другиевазодилататоры - Другие вазодилататоры
арилоксиуксуснойкислоты - арилоксиуксусной кислоты
Фолиеваякислота - Фолиевая кислота
леченияэректильной - лечения эректильной
.арилоксиуксусной - .арилоксиуксусной
поражениясоединительной - поражения соединительной
кишкии - кишки и
сульфаниламидови - сульфаниламидов и
мг - мг
(покальцию) - (по кальцию)
подобныепрепараты - подобные препараты
(покальцию - (по кальцию
гастроэзофагальнойрефлюксной болезни - гастроэзофагальной рефлюксной болезни
кальциюкарбонату) - кальцию карбонату)
суставногопротеза - суставного протеза
установкиортопедического - установки ортопедического
костно-мышечнойсистемы - костно-мышечной системы
Производныеуксусной кислоты и родственные соединения - Производные уксусной кислоты и родственные соединения
другимикостными - другими костными
итрансплантатами - и трансплантатами
свнутренним - с внутренним
обусловленныеэндопротезированием - обусловленные эндопротезированием
другимивнутренними - другими внутренними
ортопедическимипротезными - ортопедическими протезными
противовоспалительныеи - противовоспалительные и
препараты,влияющие - препараты, влияющие
аналогичныепрепараты - аналогичные препараты
иминерализацию - и минерализацию
Аминосалициловаякислота - Аминосалициловая кислота
Ингибиторыинтерлейкина - Ингибиторы интерлейкина
базисныепротиворевматические - базисные противоревматические
иног - и ног
ревматоидныеартриты - ревматоидные артриты
антихолинергическиесредства, эфиры с третичной аминогруппой - антихолинергические средства, эфиры с третичной аминогруппой
длягемотрансфузии - для гемотрансфузии
аспарагинатг - аспарагинат г
Магнияхлорид - Магния хлорид
Натрияхлорид - Натрия хлорид
хлорид+ - хлорид +
лонгум+ - лонгум +
Натриягидрокарбонат - Натрия гидрокарбонат
Натриягидроцитрат - Натрия гидроцитрат
водноэлектролитныйбаланс - водноэлектролитный баланс
Калияхлорид - Калия хлорид
гидроцитратмл - гидроцитрат мл
фециумтаблетка - фециум таблетка
диоктаэдрическийг - диоктаэдрический г
Рутозидг - Рутозид г
Лактобактериимлн. - Лактобактерии млн.
Вспомогательныесредства - Вспомогательные средства
Кальцияхлорид - Кальция хлорид
ацидофильныедоза - ацидофильные доза
Натрияглюконат - Натрия глюконат
Урсодезоксихолеваякислота - Урсодезоксихолевая кислота
Аскорбиноваякислота+Рутозид - Аскорбиновая кислота+Рутозид
Адсорбирующиекишечные препараты другие - Адсорбирующие кишечные препараты другие
гидрокарбонат+Натрияхлорид - гидрокарбонат+Натрия хлорид
Натрияацетат+Натрия - Натрия ацетат+Натрия
кислота+Рутозидг - кислота+Рутозид г
хлорид+Кальцияхлорид+Магния - хлорид+Кальция хлорид+Магния
фумаратмл - фумарат мл
Натриялактат] - Натрия лактат]
кефирныедоз - кефирные доз
кефирныекапс. - кефирные капс.
новообразованиеоколоушной - новообразование околоушной
Аминокислоты,включая - Аминокислоты, включая
препараты[Поливитамины] - препараты [Поливитамины]
нияы - ния ы
ыизмере - ы измере
наборасоциальных - набора социальных
22.12.2008,регистрационный - 22.12.2008, регистрационный
социальнойпомощи - социальной помощи
Федеральногозакона - Федерального закона
которымиосуществляется - которыми осуществляется
жизненнымпоказаниям) - жизненным показаниям)
Прогестеронмг 10 50 - Прогестерон мг 10 50
предоставленияизмерен - предоставления измерен
медицинскогоприменения, - медицинского применения,
Министерствомюстиции - Министерством юстиции
длямедицинского - для медицинского
690н(зарегистрирован - 690н (зарегистрирован
применениялекарственного - применения лекарственного
Всемирнойорганизацией - Всемирной организацией
от10.11.2011 - от 10.11.2011
рецептамврача - рецептам врача
поанатомо-терапевтическо-химической - по анатомо-терапевтическо-химической
исоциального - и социального
регистрационный№ - регистрационный №
вамбулаторных - в амбулаторных
лечебногопитания, - лечебного питания,
случаеналичия - случае наличия
втом - в том
17.07.1999№ - 17.07.1999 №
всоответствии - в соответствии
врачебнойкомиссии - врачебной комиссии
применения,зарегистрированные - применения, зарегистрированные
инфекционныхи - инфекционных и
вдругих - в других
Производныететрагидропиримиди - Производные тетрагидропиримиди
тетрагидропиримидина - тетрагидропиримидина
хламидиями(А - хламидиями (А
болеечем - более чем
Адреномиметики,токолитические - Адреномиметики, токолитические
Rho[D]мг - Rho[D] мг
токолитическиесредства - токолитические средства
человекаантирезус - человека антирезус
двухвалентногожелеза - двухвалентного железа
Ингибиторыпротонового насоса - Ингибиторы протонового насоса
кислота+Кальциякарбонат+Колекальциферол - кислота+Кальция карбонат+Колекальциферол
5550+382500+1320 - 5550+382 500+1320
С)в - С) в
карбонат+Колекальциферолмг - карбонат+Колекальциферол мг
Н2-гистаминовых - Н2- гистаминовых
лмг - л мг
Аскорбиноваякислота+Кальция - Аскорбиновая кислота+Кальция
сдругими средствами - с другими средствами
карбонат+Колекальциферол - карбонат+Колекальциферо л
185+1275+4,4 - 185+ 1275+4,4
1850+12750+44 - 1850+ 12750+44
кислота+Кальциякарбонат+Колекальциферо - кислота+Кальция карбонат+Колекальциферо
1275+4,41850+ - 1275+4,4 1850+
другимиинфекционными - другими инфекционными
пневмококковойинфекции - пневмококковой инфекции
пневмококковыхинфекций - пневмококковых инфекций
инфекций,вызываемых - инфекций, вызываемых
профилактикиинфекций, - профилактики инфекций,
influenzaeтипа - influenzae типа
профилактикипневмококковой - профилактики пневмококковой
гриппа[инактивированная] - гриппа [инактивированная]
профилактикипневмококковых - профилактики пневмококковых
вызываемыхмл - вызываемых мл
инфекциймл - инфекций мл
Интерферональфа-2b+Таурин - Интерферон альфа-2b+Таурин
[инактивированная]мл - [инактивированная] мл
ингибиторытромбина - ингибиторы тромбина
ймг - й мг
Бензилдиметил-миристоиламино-пропиламмони - Бензилдиметил-миристо иламино-пропиламмони
опоксифеноксиметилметилоксадиазол - опоксифеноксиметил метилоксадиазол
метилоксадиазол+мл - метилоксадиазол+ мл
инмг - ин мг
Гипромеллоза+Декстран - Гипромеллоза+Декстра н
нмл - н мл
антисептикидля местного лечения заболеваний полости рта - антисептики для местного лечения заболеваний полости рта
иламино-пропиламмоний - иламино-пропиламмони й
Аденозин+Никотинамид+ - Аденозин+Никотинами д+
опоксифеноксиметилметилоксадиазол+ - опоксифеноксиметил метилоксадиазол+
[Сульбактам]г - [Сульбактам] г
Гидроксиэтиламиноаденин - Гидроксиэтиламиноаденин
Иммуноглобулинпротивостолбнячный - Иммуноглобулин противостолбнячный
Иммунныесыворотки - Иммунные сыворотки
профилактикибешенства - профилактики бешенства
бешенствамл - бешенства мл
Никотиноилгамма-аминомасляная - Никотиноил гамма-аминомасляная
диазепинмг - диазепин мг
Бромдигидрохлорфенилбензо-диазепин - Бромдигидрохлорфенилбензо- диазепин
ингибиторыобратного захвата моноаминов - ингибиторы обратного захвата моноаминов
пинмг - пин мг
Диазепины,осазепины - Диазепины, осазепины
настроения[аффективные] - настроения [аффективные]
Гидразинокарбонилметилбром-фенилдигидробенздиазепин - Гидразинокарбонилметилбром-фени лдигидробенздиазепин
лдигидробенздиазепинмг - лдигидробенздиазепин мг
лидонмг - лидон мг
Бифидобактерии+Лактобактерии - Бифидобактерии+Лактобакт ерии
Поливитамины+Фосфолипиды - Поливитамины+Фосфолипид ы
ыг - ы г
Пенициллины,чувствительные - Пенициллины, чувствительные
бромидмл - бромид мл
Питофенон+Фенпивериниябромид - Питофенон+Фенпивериния бромид
абортом,внематочной - абортом, внематочной
Бисчетвертичныеаммониевые - Бисчетвертичные аммониевые
30000-50000]+Маннитол+Натрия - 30000-5 0000]+Маннитол+Натрия
[ср.мол.масса30000-5 - [ср.мол.масса 30000-5
хлорид+Кальцияхлорид+ - хлорид+Кальция хлорид+
0000]+Маннитол+Натрияхлорид - 0000]+Маннитол+Натрия хлорид
Поливитамины+Прочиепрепараты - Поливитамины+Прочие препараты
[человеческийполусинтетический] - [человеческий полусинтетический]
кефирныегрибки - кефирные грибки
грибкикапсула - грибки капсула
белладоны,третичные - белладоны, третичные
кислота+Рутозидмг - кислота+Рутозид мг
Бифидобактериилонгум+энтерококкус - Бифидобактерии лонгум+энтерококкус
хлорид+Натрияфумарат - хлорид+Натрия фумарат
лонгум+энтерококкусфециум - лонгум+энтерококкус фециум
аспарагинаттаблетка - аспарагинат таблетка
глюконат+Натрияхлорид - глюконат+Натрия хлорид
хлорид+Натриягидрокарбонат+Натрия - хлорид+Натрия гидрокарбонат+Натрия
болезней,классифицированных - болезней, классифицированных
Ацетилцистеин+Туаминогептан - Ацетилцистеин+Туаминогепта н
препаратыдоза - препараты доза
заболеванийжелчевыводящих путей - заболеваний желчевыводящих путей
наводно-электролитны й баланс - на водно-электролитны й баланс
хлорид+Магнияхлорид+ - хлорид+Магния хлорид+
показатель - показател ь
вленияы - вления ы
классификацияпрепарата*(3) - классификация препарата*(3)
ныйпоказател - ный показател
частотыпредоста - частоты предоста
илидисфункцией - или дисфункцией
дисфункциейголовного - дисфункцией головного
Диазепаммг 10 10 - Диазепам мг 10 10
ипротиворевматическими - и противоревматическими
офтальмологической,отоларингологической - офтальмологической, отоларингологической
неклассифицированное - не классифицированное
другихмикотоксинов - других микотоксинов
насердечно-сосудистую - на сердечно-сосудистую
органыпищеварения - органы пищеварения
пищевыхморепродуктах - пищевых морепродуктах
противопаразитарнымисредствами - противопаразитарными средствами
средствами,медикаментами - средствами, медикаментами
съеденныхпищевых - съеденных пищевых
накожу - на кожу
искелетную - и скелетную
игематологическими - и гематологическими
бензодиазепинадиазепам мг 10 10 - бензодиазепина диазепам мг 10 10
аппараталоктевого - аппарата локтевого
коленногосустава - коленного сустава
аппаратаголеностопного - аппарата голеностопного
уровнезапястья - уровне запястья
аппарататазобедренного - аппарата тазобедренного
аппаратаплечевого - аппарата плечевого
Натрияхлорид] - Натрия хлорид]
антисептикии дезинфицирующие средства - антисептики и дезинфицирующие средства
ароматическихуглеводородов - ароматических углеводородов
Стимуляторыдыхания - Стимуляторы дыхания
натрияг - натрия г
суставов,захватывающие - суставов, захватывающие
классифицированныев - классифицированные в
Растворы,электролитов - Растворы, электролитов
электролитный баланс - электролитны й баланс
употреблениемнескольких - употреблением нескольких
другихстимуляторов - других стимуляторов
расстройства,вызванные - расстройства, вызванные
илиснотворных - или снотворных
психоактивныхвеществ - психоактивных веществ
ииспользованием - и использованием
вводу - в воду
ипротивопаркинсоническими - и противопаркинсоническими
действующимипреимущественно - действующими преимущественно
противосудорожными,седативными, - противосудорожными, седативными,
нервнуюсистему - нервную систему
итерапевтическими - и терапевтическими
Аскорбиноваякислота (витамин - Аскорбиновая кислота (витамин
впояснично-крестцовом - в пояснично-крестцовом
аппаратапоясничного - аппарата поясничного
аппаратана - аппарата на
ипочек - и почек
спреимущественным - с преимущественным
спочечной - с почечной
сердца[гипертоническая - сердца [гипертоническая
сердечнойнедостаточностью - сердечной недостаточностью
почечнойнедостаточностью - почечной недостаточностью
Агонистыимидазолиновых - Агонисты имидазолиновых
кровотечениенеуточненное - кровотечение неуточненное
малмл - мал мл
Транексамоваякислота - Транексамовая кислота
иразбавители,включая - иразбавители, включая
Натриямл - Натрия мл
Этанол]мл - Этанол] мл
генно-инженерный]мл - генно-инженерный] мл
бифидумдоз - бифидум доз
плодовэкстракт - плодов экстракт
нуклеотиды-ингибиторыобратной - нуклеотиды-ингибиторы обратной
инуклеотиды-ингибиторы - и нуклеотиды-ингибиторы
трактаи - тракта и
альфа-2bмг - альфа-2b мг
акридонацетатмг - акридонацетат мг
диоктаэдрическиймг - диоктаэдрический мг
лечениязаболеваний печени - лечения заболеваний печени
калиядицитрат - калия дицитрат
[человеческиймл - [человеческий мл
длялечения заболеваний желчевыводящих путей - для лечения заболеваний желчевыводящих путей
хлоридараствор - хлорида раствор
спротивокашлевыми - с противокашлевыми
Отхаркивающиепрепараты, - Отхаркивающие препараты,
противокашлевымисредствами - противокашлевыми средствами
альфа-2b+Таурин - альфа-2b +Таурин
кромекомбинаций - кроме комбинаций
Магнияхлорид+Натрия - Магния хлорид+Натрия
ацетат+ - ацетат +
Желчь+ - Желчь +
+г - + г
Пропионилфенилэтоксиэтил-пиперидин - Пропионилфенилэтоксиэтил- пиперидин
пиперидинмг - пиперидин мг
моторикужелудочно-кишечного тракта - моторику желудочно-кишечного тракта
.противоревматические - .противоревматические
/лучевой - / лучевой
прифотодинамической - при фотодинамической
нормальныйг - нормальный г
Комбинированныепротивовирусные - Комбинированные противовирусные
путейи - путей и
средствав - средства в
бисульфитмг - бисульфит мг
натриябисульфит - натрия бисульфит
идымг - иды мг
леченияфункциональных - лечения функциональных
дипептидилпептидазы-4(ДПП-4) - дипептидилпептидазы-4 (ДПП-4)
послемедицинских - после медицинских
есредства - е средства
дляобщей анестезии - для общей анестезии
Бензилдиметилмиристоиламино-пропиламмоний - Бензилдиметилмиристоилами но-пропиламмоний
Бутиламиногидроксипропокси - Бутиламиногидроксипропокс и
серотониновых5HT3-рецепторов - серотониновых 5HT3-рецепторов
Вмл - В мл
позвоночникаи - позвоночника и
отделапозвоночника - отдела позвоночника
противовоспалительные препараты для местного применения - противовоспалительные препараты для местного применения
Ацетиламиноянтарнаякислота - Ацетиламиноянтарная кислота
бредовое[шизофреноподобное] - бредовое [шизофреноподобное]
илисоматической - или соматической
психическиерасстройства, - психические расстройства,
повреждениеми - повреждением и
илидругими - или другими
Алифатическиепроизводные фенотиазина - Алифатические производные фенотиазина
о-диазепинмг - о-диазепин мг
Производныеиндола - Производные индола
Прочиепарасимпатомиметики - Прочие парасимпатомиметики
+[Карбидопа] - + [Карбидопа]
[Карбидопа]мг - [Карбидопа] мг
Противоэпилептические - Противоэпилептические
ирролидонмг - ирролидон мг
Н-карбамоилметил-4-фенил-2-пирролидон - Н-карбамоилметил-4-фенил-2-п ирролидон
Веносклерозирующиесредства - Веносклерозирующие средства
локальныхинъекций - локальных инъекций
Антисептическиепрепараты - Антисептические препараты
отхаркивающиесредства - отхаркивающие средства
иотхаркивающие - и отхаркивающие
иантисептик - и антисептик
заболеванийгорла - заболеваний горла
хлоридмг - хлорид мг
Дезлоратадинмг 2,5 25 - Дезлоратадин мг 2,5 25
заболеванийполости - заболеваний полости
пентандиовойкислоты - пентандиовой кислоты
спиртмг - спирт мг
местноголечения - местного лечения
включаякомбинации с ингибиторами бета-лактамаз - включая комбинации с ингибиторами бета-лактамаз
средства,увеличивающие - средства, увеличивающие
оболочкаг - оболочка г
объемкишечного - объем кишечного
овальногосемян - овального семян
длялечения угревой сыпи - для лечения угревой сыпи
лмкг - л мкг
альфа[активированный] - альфа [активированный]
Дезогестрел+Этинилэстрадиол - Дезогестрел+Этинилэстрадио л
[активированный]мг - [активированный] мг
Производныететрагидропиримидина - Производные тетрагидропиримидина
иего аналоги) - и его аналоги)
новообразованиепочки, - новообразование почки,
низкоосмолярныерентгеноконтрастн - низкоосмолярные рентгеноконтрастн
вегетативнойнервной - вегетативной нервной
новообразованиепериферических - новообразование периферических
другихтипов - других типов
коагулянтныйкомплекс - коагулянтный комплекс
новообразованиякожи - новообразования кожи
кровиантикоагулянтами - крови антикоагулянтами
комбинации[Протромбиновый - комбинации [Протромбиновый
неуточненныхлокализаций - неуточненных локализаций
рентгеноконтрастные средства - рентгеноконтрастные средства
кислотаммоль - кислота ммоль
ыенефротропные - ые нефротропные
нефротропныенизкоосмолярны - нефротропные низкоосмолярны
Водорастворимые - Водорастворимые
Гадопентетоваякислота - Гадопентетовая кислота
низкоосмолярные - низкоосмолярные
ерентгеноконтрастные - е рентгеноконтрастные
-перидинмг - -перидин мг
Пропионилфенилэтоксиэтилпи-перидин - Пропионилфенилэтоксиэтилпи -перидин
Прокаинмг 150 150 - Прокаин мг 150 150
Лидокаинмг 200 1200 - Лидокаин мг 200 1200
гипогликемическихсредств - гипогликемических средств
гипогликемическнепрепараты, - гипогликемическне препараты,
Другиегипогликемическне - Другие гипогликемическне
пероральныхгипогликемических - пероральных гипогликемических
дефицитомферментов - дефицитом ферментов
егоагонисты - его агонисты
Аналогигонадотропин-рилизи - Аналоги гонадотропин-рилизи
(дляпоследовательного - (для последовательного
последовательногоприема) - последовательного приема)
секвенциальныепрепараты - секвенциальные препараты
эстрогены,секвенциальные - эстрогены, секвенциальные
Антибиотикистероидной - Антибиотики стероидной
там]г - там] г
ндоза - н доза
Салметерол+Флутиказон - Салметерол+Флутиказо н
[Тазобактам]г - [Тазобактам] г
Пиперациллин+[Тазобактам] - Пиперациллин+ [Тазобактам]
Глюкокортикостероиды - Глюкокортикостероиды
бромид+Фенотеролмл - бромид+Фенотерол мл
Тикарциллин+[Клавулановая - Тикарциллин+ [Клавулановая
ивнутрипеченочных - и внутрипеченочных
Прокаинмг 50 50 - Прокаин мг 50 50
Водорастворимыенейротропные - Водорастворимые нейротропные
нейротропныенизкоосмолярные - нейротропные низкоосмолярные
Лидокаинмг 20 20 - Лидокаин мг 20 20
Гадоксетоваякислота - Гадоксетовая кислота
новообразованиеподжелудочной - новообразование поджелудочной
Кишечныеадсорбенты - Кишечные адсорбенты
прямойкишки - прямой кишки
Эфирыаминобензойной кислоты - Эфиры аминобензойной кислоты
шейкиматки - шейки матки
новообразованиегрушевидного - новообразование грушевидного
нижнейчасти - нижней части
бензодиазепинмг - бензодиазепин мг
предоставленияизмерени - предоставления измерени
-бензодиазепин - - бензодиазепин
епинмг - епин мг
симптоматическаяэпилепсия - симптоматическая эпилепсия
парциальнымиприпадками - парциальными припадками
фокальнымначалом - фокальным началом
эпилепсияи - эпилепсия и
парциальнымисудорожными - парциальными судорожными
К-карбамоилметил-4-фенил-2-пирролидон - К-карбамоилметил-4-фенил-2- пирролидон
анестетикидля - анестетики для
бактериальныхинфекций - бактериальных инфекций
Парацетамол+Фенилэфрин+ - Парацетамол+Фенилэфрин +
Фенираминмг - Фенирамин мг
+Хлорфенаминмг - +Хлорфенамин мг
птандоза - птан доза
Парацетамол+Фенилэфрин+Хлорфенамин - Парацетамол+Фенилэфрин +Хлорфенамин
Парацетамол+Хлорфенамин+[Аскорбиновая - Парацетамол+Хлорфенами н+[Аскорбиновая
другимиуточненными - другими уточненными
Бензокаин+Цетилпиридинияхлорид - Бензокаин+Цетилпиридиния хлорид
Антибиотик-пенициллин - Антибиотик-пеницил лин
Амилметакрезол+Дихлорбензиловый - Амилметакрезол+Дихлорбензило вый
линполусинтетический - лин полусинтетический
H1-гистаминовыхрецепторов - H1-гистаминовых рецепторов
неуточнен - неуточнен
Mycoplasmapeumoiae - Mycoplasma peumoiae
инфекциянижних - инфекция нижних
инфекциейнижних - инфекцией нижних
Цефтазидиммг 4000 28000 - Цефтазидим мг 4000 28000
Цефиксиммг 400 2800 - Цефиксим мг 400 2800
Сальбутамолдоза - Сальбутамол доза
Фенотеролмг - Фенотерол мг
натриямг 500 500 - натрия мг 500 500
ибедренной - и бедренной
Магниякарбонат - Магния карбонат
ь]мкг - ь] мкг
декстранмг - декстран мг
гидроксиддекстран - гидроксид декстран
игиперфосфатемии - и гиперфосфатемии
[метоксиполиэтиленгликоль] - [метоксиполиэтиленгликол ь]
Алгелдрат+Магниягидроксид - Алгелдрат+Магния гидроксид
лечениягиперкалиемии - лечения гиперкалиемии
бета[метоксиполиэтиленгликол - бета [метоксиполиэтиленгликол
карбонатмг - карбонат мг
Прочиеантипаратиреоидные - Прочие антипаратиреоидные
антипаратиреоидныепрепараты - антипаратиреоидные препараты
Кетоаналогиаминокислот - Кетоаналоги аминокислот
Кальциякарбонат+Магния - Кальция карбонат+Магния
коль]мкг - коль] мкг
аминокислотмг - аминокислот мг
карбонат+Магниякарбонат - карбонат+Магния карбонат
бета[метоксиполиэтиленгли - бета [метоксиполиэтиленгли
Бифидобактериилонгум+Энтерококкус - Бифидобактерии лонгум+Энтерококкус
Бифидобактериибифидум+Кишечные - Бифидобактерии бифидум+Кишечные
бифидум+Кишечныепалочки - бифидум+Кишечные палочки
парентеральногопитания+Прочие - парентерального питания+Прочие
10+2[Клавулановая - 10+2 [Клавулановая
средствами,кроме - средствами, кроме
инфекционныхболезней - инфекционных болезней
илинеуточненной - или неуточненной
influenzaeмл - influenzae мл
[живая]мл - [живая] мл
этиловыйэфир - этиловый эфир
профилактикигриппа - профилактики гриппа
Haemophilusinfluenzae - Haemophilus influenzae
инометил-гидроксиброминдолкарбоновой - инометил-гидроксиброминдол карбоновой
Иммуноглобулинантирабический - Иммуноглобулин антирабический
частипредплечья - части предплечья
дляместной - для местной
костнойгрудной - костной грудной
отделакостной - отдела костной
В+Фенилэфриндоза - В+Фенилэфрин доза
Дексаметазон+Неомицин+Полимиксин - Дексаметазон+Неомицин+Пол имиксин
противомикробными - противомикробными
спротивомикробным - с противомикробным
Лидокаин+Неомицин+Полимиксин - Лидокаин+Неомицин+Полими ксин
заболеванийуха - заболеваний уха
ианестетики - и анестетики
дляпрофилактики бешенства - для профилактики бешенства
текущийэпизод - текущий эпизод
эпизодлегкой - эпизод легкой
оксазепиныи - оксазепины и
[эпизодическаяпароксизмальная - [эпизодическая пароксизмальная
одиазепинмг - одиазепин мг
расстройство,текущее - расстройство, текущее
расстройство,текущая - расстройство, текущая
инфекционногопроисхождения - инфекционного происхождения
хлорид+Натриялактат+Натрия - хлорид+Натрия лактат+Натрия
фециумкапсула - фециум капсула
ацидофильные+Кефирныегрибки - ацидофильные+Кефирные грибки
Декстроза+Натриягидроцитрат - Декстроза+Натрия гидроцитрат
лонгум+Энтерококкусфециум - лонгум+Энтерококкус фециум
iпротивовоспалительн - i противовоспалительн
Другиеирригационные растворы - Другие ирригационные растворы
5+1кислота] - 5+1 кислота]
Преднизолонмг 60 60 - Преднизолон мг 60 60
расстройства\ - расстройства \
психотическиерасстройства - психотические расстройства
иориентацией - и ориентацией
фенотиазинамг - фенотиазина мг
Алкалоиды,белладонны, - Алкалоиды, белладонны,
Медицинскиегазы - Медицинские газы
Глюкокортикоиды - Глюкокортикоиды
конечности,исключая - конечности, исключая
пораженнойповерхности - пораженной поверхности
инижней - и нижней
ипрепараты плазмы крови - и препараты плазмы крови
Глюкокортикоидыг - Глюкокортикоиды г
Неселективныебета- - Неселективные бета-
бромид+Фенотеролмкг - бромид+Фенотерол мкг
сдругими препаратами - с другими препаратами
ридинмг - ридин мг
Левотироксиннатрия+Калия - Левотироксин натрия+Калия
Левотироксиннатрия+Лиотиронин - Левотироксин натрия+Лиотиронин
натрия+Лиотиронинмкг - натрия+Лиотиронин мкг
йодидмкг - йодид мкг
НТ3- - НТ3 -
моторикужелудочно-кишечног - моторику желудочно-кишечног
ацидофильныедоз - ацидофильные доз
противогрибковыепрепараты системного действия - противогрибковые препараты системного действия
Блокаторысеротониновых 5 - Блокаторы серотониновых 5
иперидинмг - иперидин мг
НТ3-рецепторов - НТ3 -рецепторов
применяемыепри - применяемые при
Аминолевулиноваякислота - Аминолевулиновая кислота
ам]г - ам] г
30000-40000]мл - 30000-40000] мл
[ср.мол.масса30000-40000] - [ср.мол.масса 30000-40000]
тилпиперидинмг - тилпиперидин мг
сингибиторами бета-лактамаз - с ингибиторами бета-лактамаз
илегкого - и легкого
динмг - дин мг
противорвотныепрепараты - противорвотные препараты
Другиепротиворвотные - Другие противорвотные
Кетопрофенмг 500 500 - Кетопрофен мг 500 500
кромепочечной - кроме почечной
[Декстроза+Минералы]мл - [Декстроза+Минералы] мл
вещества,витамины в комбинации - вещества, витамины в комбинации
препараты[Декстроза+Минералы] - препараты [Декстроза+Минералы]
Антиаритмическиепрепараты, класс - Антиаритмические препараты, класс
Колониестимулирующие факторы - Колониестимулирующие факторы
сахарозныйкомплекс - сахарозный комплекс
Кетаминмг 100 200 - Кетамин мг 100 200
Галогенизированныеуглеводороды - Галогенизированные углеводороды
Пропофолмг 200 400 - Пропофол мг 200 400
Антихолинэстеразныепрепараты - Антихолинэстеразные препараты
Аналогигонадотропинрилизинг - Аналоги гонадотропинрилизинг
натриямг 400 800 - натрия мг 400 800
гонадотропинрилизинггормона - гонадотропинрилизинг гормона
Аминоалькильныеэфиры - Аминоалькильные эфиры
бромидмг 12 12 - бромид мг 12 12
Ропивакаинмг 150 300 - Ропивакаин мг 150 300
Буливакаинмг 100 200 - Буливакаин мг 100 200
Севофлуранмл 8 8 - Севофлуран мл 8 8
бромидмг 50 100 - бромид мг 50 100
поясничногоотдела - поясничного отдела
Цефотаксиммг 4000 40000 - Цефотаксим мг 4000 40000
Другиепарасимпатомиметик и - Другие парасимпатомиметик и
В+Фенилэфринмл - В+Фенилэфрин мл
идезинфицирующие средства - и дезинфицирующие средства
8000+4000[Сульбактам] - 8000+4000 [Сульбактам]
устойчивыек - устойчивые к
Цефалоспорины2-го - Цефалоспорины 2-го
ам]мг - ам] мг
Амоксициллин+[Сульбактам] - Амоксициллин+[Сульбакт ам]
ическо-химическаяклассификация - ическо-химическая классификация
противостолбнячныйчеловека - противостолбнячный человека
Бупивакаинмг 15 15 - Бупивакаин мг 15 15
30000+кислота] - 30000+ кислота]
ензодиазепинмг - ензодиазепин мг
иантипиретики - и антипиретики
нилбензо-диазепинмг - нилбензо-диазепин мг
Тиоридазинмг 600 18000 - Тиоридазин мг 600 18000
Натриягидрокарбонат+ - Натрия гидрокарбонат+
[Минералы]мл - [Минералы] мл
Натрияхлорид+Повидон-8 - Натрия хлорид+Повидон-8
препараты[Минералы] - препараты [Минералы]
Ингибиторыпролактина - Ингибиторы пролактина
столбанеуточненная - столба неуточненная
перинатальномпериоде - перинатальном периоде
вперинатальном - в перинатальном
[IgG+IgM+IgA]мл - [IgG+IgM+IgA] мл
Флуконазолмг 50 500 - Флуконазол мг 50 500
споздним - с поздним
раннимначалом - ранним началом
Альцгеймера,атипичная - Альцгеймера, атипичная
Бензодиазепиноподобные средства - Бензодиазепиноподобные средства
Другиеантипсихотические средства - Другие антипсихотические средства
тыс.мл - тыс. мл
30000-40000] - 30000- 40000]
40000]мл - 40000] мл
Повидон-8тыс. - Повидон-8 тыс.
гидрокарбонат+Натрияхлорид+Повидон-8 - гидрокарбонат+Натрия хлорид+Повидон-8
влияющиена водно-электролитный баланс - влияющие на водно-электролитный баланс
Моклобемидмг 600 25200 - Моклобемид мг 600 25200
Неселективныеингибиторы обратного захвата моноаминов - Неселективные ингибиторы обратного захвата моноаминов
калийсберегающимидиуретиками - калийсберегающими диуретиками
Тиазидоподобныедиуретики - Тиазидоподобные диуретики
азепинмг - азепин мг
скалийсберегающими - с калийсберегающими
респираторнымипроявлениями, - респираторными проявлениями,
гриппаидентифицирован - гриппа идентифицирован
вирусгриппа - вирус гриппа
неидентифицирован - не идентифицирован
-диметиламинометил - - диметиламинометил
-гидроксиброминдол - - гидроксиброминдол
таб.*(6) - таб.*(6 )
слоеммл 200 400 - слоем мл 200 400
плазмамл 200 400 - плазма мл 200 400
пенициллин полусинтетический - пеницил лин полусинтетический
гистаминовыхрецепторов блокатор - гистаминовых рецепторов блокатор
Лидокаинмг - Лидокаин мг
Цетилпиридинияхлорид - Цетилпиридиния хлорид
недостаточностьнеуточненная - недостаточность неуточненная
карбонатг - карбонат г
бета[метоксиполиэтиленгликоль] - бета [метоксиполиэтиленгликоль]
[метоксиполиэтиленгликоль]мкг - [метоксиполиэтиленгликоль] мкг
идезинфицирующи - и дезинфицирующи
дезинфицирующие - дезинфицирующие
Хлоргексидинмл 80 80 - Хлоргексидин мл 80 80
перитонеальногодиализа - перитонеального диализа
Кровезаменителии - Кровезаменители и
дляперитонеального - для перитонеального
моторикижелудочно-кише - моторики желудочно-кише
диализамл - диализа мл
снизкой активностью (группа - с низкой активностью (группа
кефирныекапсул - кефирные капсул
включаякомбинацию - включая комбинацию
частотыпредоставл - частоты предоставл
енияы - ения ы
хлоридг - хлорид г
медицинскихпроцедур - медицинских процедур
[смесьэфиров] - [смесь эфиров]
эфиров]мг - эфиров] мг
Антибактериальныепрепараты - Антибактериальные препараты
Антигонадотропин-рилизинг - Антигонадотропин-рилизинг
IgA]доза - IgA] доза
ацидофильные+ - ацидофильные +
ЕД(по - ЕД (по
Энтерококкусфециум - Энтерококкус фециум
Бифидобактериилонгум+ - Бифидобактерии лонгум+
Эпоэтинальфа - Эпоэтин альфа
противоопухолевой - противоопухолевой
Бариясульфат - Бария сульфат
альфамкг - альфа мкг
Аналогипиримидина - Аналоги пиримидина
нефротропныевысокоосмолярн - нефротропные высокоосмолярн
Дезинтоксикационные - Дезинтоксикационные
Кальцияфолинат - Кальция фолинат
фолинатмг 50 50 - фолинат мг 50 50
Производныеподофиллотокси - Производные подофиллотокси
Рентгеноконтрастные - Рентгеноконтрастные
Препаратыплатины - Препараты платины
высокоосмолярные - высокоосмолярные
ерентгеноконтраст - е рентгеноконтраст
подофиллотоксина - подофиллотоксина
сульфатг - сульфат г
ыерентгеноконтраст - ые рентгеноконтраст
Дарбэпоэтинальфа - Дарбэпоэтин альфа
дляпротивоопухолев - для противоопухолев
средства,содержащие - средства, содержащие
Другиепротивотуберкулезн - Другие противотуберкулезн
Производныетиокарбамида - Производные тиокарбамида
противотуберкулезные - противотуберкулезные
иседативные - и седативные
противокашлевыепрепараты - противокашлевые препараты
Ингибиторыферментов - Ингибиторы ферментов
Аналогигонадотропин-рилиз инг гормона - Аналоги гонадотропин-рилиз инг гормона
тромбоцитопеническаяпурпура - тромбоцитопеническая пурпура
натриямг 0,1 36,5 - натрия мг 0,1 36,5
преходящимтиреотоксикозом - преходящим тиреотоксикозом
Салициловаякислота - Салициловая кислота
производныеимидазола - производные имидазола
Селективныебета-адреноблокато - Селективные бета-адреноблокато
Серосодержащиепроизводные - Серосодержащие производные
уточненнымиосложнениями - уточненными осложнениями
Производныесульфонилмочевин - Производные сульфонилмочевин
сульфонилмочевины - сульфонилмочевины
Инсулиныкороткого - Инсулины короткого
полигландулярнаянедостаточность - полигландулярная недостаточность
Аналогигонадотропин-ри - Аналоги гонадотропин-ри
иполусинтетическ - и полусинтетическ
полусинтетические - полусинтетические
ожиренияцентрального - ожирения центрального
ожиренияпериферического - ожирения периферического
Метформинмг - Метформин мг
продолжительностидействия и их аналоги в комбинации с инсулинами короткого действия для инъекционного введения - продолжительности действия и их аналоги в комбинации с инсулинами короткого действия для инъекционного введения
Гормоны,расщепляющие гликоген - Гормоны, расщепляющие гликоген
смножественными - с множественными
снеуточненными - с неуточненными
сахарногодиабета - сахарного диабета
споражениями - с поражениями
сневрологическими - с неврологическими
безосложнений - без осложнений
медицинскихпроцедур, - медицинских процедур,
поступлениемэнергетических - поступлением энергетических
нияизмере - ния измере
сходныесостояния - сходные состояния
железы,связанные - железы, связанные
-гопоколения - -го поколения
клинг - клин г
Клотримазолг - Клотримазол г
Гидрокортизон+Окситетрациклин - Гидрокортизон+Окситетраци клин
(застойной)сердечной - (застойной) сердечной
Валсартан+Гидрохлоротиазид - Валсартан+Гидрохлороти азид
иазидмг - иазид мг
кальциевыхканалов - кальциевых каналов
сдиуретиками - с диуретиками
Гидрохлоротиазид+Телмисартан - Гидрохлоротиазид+Телми сартан
сблокаторами - с блокаторами
отиазидмг - отиазид мг
азидмг - азид мг
танмг - тан мг
Бисопролол+Гидрохлоротиазид - Бисопролол+Гидрохлорот иазид
Гидрохлоротиазид+Лозартан - Гидрохлоротиазид+Лозар тан
сартанмг - сартан мг
Амлодипин+Валсартан+Гидрохлор - Амлодипин+Валсартан+Г идрохлор
Диэтиламинопропионилэтоксикарбонил-аминофенотиазин - Диэтиламинопропионилэтоксикар бонил-аминофенотиазин
Антиаритмическиепрепараты, класс 1 - Антиаритмические препараты, класс 1
бонил-аминофенотиазинмг - бонил-аминофенотиазин мг
Диэтиламинопропионилэтоксикарбониламинофенот - Диэтиламинопропионилэт оксикарбониламинофенот
Лаппаконитинагидробромид - Лаппаконитина гидробромид
иазинмг - иазин мг
гидробромидмг - гидробромид мг
оксикарбониламинофенотиазин - оксикарбониламинофенот иазин
Колекальциферолг - Колекальциферол г
Метотрексатмг 20 480 - Метотрексат мг 20 480
воспалительныеспондилопатии - воспалительные спондилопатии
спондилопатиинеуточненные - спондилопатии неуточненные
энтеропатическиеартропатии - энтеропатические артропатии
приболезнях, - при болезнях,
Селективныебета-адреноблокатор ы - Селективные бета-адреноблокатор ы
наструктуру - на структуру
опухолиальфа - опухоли альфа
ипротиворевматически - и противоревматически
нестероидныепротивовоспалительн - нестероидные противовоспалительн
ианалогичные - и аналогичные
противоревматические - противоревматические
минерализациюкостей - минерализацию костей
Ингибиторытестостерон-5-альф - Ингибиторы тестостерон-5-альф
Ингибиторытестостерон-5-альфа- - Ингибиторы тестостерон-5-альфа-
Фосфомицинмг 3 3 - Фосфомицин мг 3 3
Общетонизирующие - Общетонизирующие
Грибкикефирные - Грибки кефирные
IgA]доз - IgA] доз
фециуммлн. - фециум млн.
хлорид+мл - хлорид+ мл
помощиматери - помощи матери
ключицы,лопатки - ключицы, лопатки
плечевогопояса - плечевого пояса
иплеча - и плеча
Ингибиторытромбина прямые - Ингибиторы тромбина прямые
плечевойкости - плечевой кости
илучевой - и лучевой
локтевойи - локтевой и
Прямыеингибиторы - Прямые ингибиторы
Активированныйуголь - Активированный уголь
Калияхлорид+Натрия - Калия хлорид+Натрия
угольг - уголь г
ацетат+Натрияхлорид - ацетат+Натрия хлорид
Противодиарейные - Противодиарейные
хлорид+Натрияцитрат - хлорид+Натрия цитрат
хлорид+Натриямл - хлорид+Натрия мл
Замещенныеалкиламины - Замещенные алкиламины
хлорид+Натрияацетат+ - хлорид+Натрия ацетат+
натрия+Питофенон+Фенпивериния - натрия+Питофенон+Фенп ивериния
ивериниябромид - ивериния бромид
акридонацетатг - акридонацетат г
Другиеиммуностимулято - Другие иммуностимулято
иммуностимуляторы - иммуностимуляторы
заболеванийдыхательных путей - заболеваний дыхательных путей
местнойанестезии - местной анестезии
Лактобактериимлн.КОЕ - Лактобактерии млн.КОЕ
Рутозидмг - Рутозид мг
Глицирризиноваякислота+ - Глицирризиновая кислота+
Препаратыжелчных - Препараты желчных
влияющиена водно-электролитны й баланс - влияющие на водно-электролитны й баланс
ипидымг - ипиды мг
ССД*(3) - ССД*(3 )
о-химическаяклассификация - о-химическая классификация
лекарственногопрепарата*(2) - лекарственного препарата*(2)
частотапредоставле - частота предоставле
Усредненная - Усредненна я
Ингибиторыкарбонгидразы - Ингибиторы карбонгидразы
Глюкокортикоидымг 600 3000 - Глюкокортикоиды мг 600 3000
актам]мг - актам] мг
Хлорамфениколмг - Хлорамфеникол мг
Натриямл 1000 7000 ацетат+ - Натрия мл 1000 7000 ацетат+
ско-химическаяклассификация - ско-химическая классификация
включаяирригационные растворы - включая ирригационные растворы
Макролидымг 500 2500 - Макролиды мг 500 2500
Инозин+Никотинамид+Рибофлавин+Янтарн - Инозин+Никотинамид +Рибофлавин+Янтарн
+Рибофлавин+Янтарная - +Рибофлавин+Янтарн ая
Производныепипоразина - Производные пипоразина
частотыпредостав - частоты предостав
Туаминогептандоза - Туаминогептан доза
дипептидмг - дипептид мг
Глюкозаминилмурамилдипептид - Глюкозаминилмурамилдипептид
______________________________- - ______________________________ -
проблем,связанных - проблем, связанных
Фторхинолоны - Фторхинолоны
Кальцияглицерофосфа - Кальция глицерофосфа
Аминокапроновая - Аминокапроновая
мыенефротропные - мые нефротропные
Декскетопрофен - Декскетопрофен
Другиеирригационны - Другие ирригационны
Другиепротивоэпиле - Другие противоэпиле
пенициллинов, - пенициллинов,
Комбинациипенициллинов - Комбинации пенициллинов
Оксациллинмг - Оксациллин мг
нефротропныенизкоосмоляр - нефротропные низкоосмоляр
Гадопентетовая - Гадопентетовая
бензодиазепина - бензодиазепина
Парамагнитные - Парамагнитные
Ципрофлоксацин - Ципрофлоксацин
Дифенгидрамин - Дифенгидрамин
Другиесистемные - Другие системные
ензойнаякислота - ензойная кислота
тмг - т мг
аминогликозиды - аминогликозиды
астныесредства - астные средства
Фенпивериниябромид - Фенпивериния бромид
противогрибковые препараты системного действия - противогрибковые препараты системного действия
птическиепрепараты - птические препараты
длительногодействия и их аналоги для инъекционног о введения - длительного действия и их аналоги для инъекционног о введения
Кларитромицин - Кларитромицин
Муколитические - Муколитические
Алкалоидыопия - Алкалоиды опия
Производныебензодиазепин - Производные бензодиазепин
Кальцияглюконат - Кальция глюконат
Ацетилцистеин - Ацетилцистеин
Блокаторысеротониновы - Блокаторы серотониновы
Производныеопия - Производные опия
глицерофосфат - глицерофосфат
н+[Клавулановая - н+[Клавулано вая
Производныефенилпиперид - Производные фенилпиперид
Аминокислоты - Аминокислоты
ирригационные - ирригационные
сотхаркивающи - с отхаркивающи
Ампициллин+ - Ампициллин +
Терпингидратмг - Терпингидрат мг
Пропионилфенилэтоксиэтил - Пропионилфе нилэтоксиэтил
серотониновых - серотониновых
гидрокарбонатмг - гидрокарбонат мг
Сульфонамиды - Сульфонамиды
Цефалоспорины - Цефалоспорины
фенилпиперидина - фенилпиперидина
енмг - ен мг
Метамизолнатрия - Метамизол натрия
Парацетамолмг - Парацетамол мг
Амоксициллин+[Клавулано - Амоксицилли н+[Клавулано
х5НТЗ-рецепто - х 5НТЗ-рецепто
Инсулингларгин - Инсулин гларгин
Анальгетикисо - Анальгетики со
глюконатмг - глюконат мг
Транексамовая - Транексамовая
нилэтоксиэтилпиперидин - нилэтоксиэтил пиперидин
ныерентгеноконтр - ные рентгеноконтр
Другиеаминогликози - Другие аминогликози
Аминометилбензойная - Аминометилбензойная
отхаркивающими - отхаркивающими
Кровезаменители - Кровезаменители
моторикижелудочно-кишечного тракта - моторики желудочно-кишечного тракта
ил-пиперидинмг - ил-пиперидин мг
молочнойжелезы - молочной железы
5)предоставления - 5) предоставления
Метамизолнатрия+Питофенон+Фенпиверин - Метамизол натрия+Питофенон+Фенпиверин
олмг - ол мг
Дротаверин+Кодеин+Парацетамол - Дротаверин+Кодеин+Парацетам ол
моторикужелудочно-кишеч - моторику желудочно-кишеч
Синтетическиеантихолинергичес - Синтетические антихолинергичес
Салициловаякислота и ее производные - Салициловая кислота и ее производные
средства,эфиры - средства, эфиры
другихотделов - других отделов
Производныенитрозомочевины - Производные нитрозомочевины
сосмодиуретическим действием - с осмодиуретическим действием
алкилирующиесредства - алкилирующие средства
противоопухолевойтерапии - противоопухолевой терапии
иразбавители, включая ирригационные растворы - и разбавители, включая ирригационные растворы
бифидум+ - бифидум +
нияизмерен - ния измерен
сульфат+Фолиеваякислота - сульфат+Фолиевая кислота
гидроксидсахарозный - гидроксид сахарозный
Другиегемостатические - Другие гемостатические
нарушенийжелудочно-кишечного - нарушений желудочно-кишечного
Железасульфат+Фолиевая - Железа сульфат+Фолиевая
гемостатическиесредства - гемостатические средства
Парентеральныепрепараты трехвалентного железа - Парентеральные препараты трехвалентного железа
моторикужелудочно-кишечно - моторику желудочно-кишечно
Парамагнитныеконтрастные средства - Парамагнитные контрастные средства
Количество - Количество
Алкалоидыбелладонны, третичные амины - Алкалоиды белладонны, третичные амины
Глицирризиноваякислота+Фосфолипиды - Глицирризиновая кислота+Фосфолипиды
кислота+Фосфолипидымг - кислота+Фосфолипиды мг
нуклеотиды-ингибиторы - нуклеотиды-ингибит оры
электролитов0,71+0,5 - электролитов 0,71+0,5
инуклеотиды-ингибит - и нуклеотиды-ингибит
системыод - системы од
Прочиепротивоопухолевые препараты - Прочие противоопухолевые препараты
глюконатмг 500 5000 - глюконат мг 500 5000
иммунодефицитачеловека - иммунодефицита человека
проявляющаясяв - проявляющаяся в
злокачественноеновообразование - злокачественное новообразование
Йопромидмг 370 370 - Йопромид мг 370 370
-пиперидинмг - -пиперидин мг
длялечения псориаза для наружного применения - для лечения псориаза для наружного применения
Рибофлавин+Янтарная - Рибофлавин+Янтарна я
[III]гидроксида - [III] гидроксида
Пенициллиныширокого спектра действия - Пенициллины широкого спектра действия
Аминодигидрофталазиндион - Аминодигидрофталазиндион
угольмг - уголь мг
кислота+мг - кислота+ мг
вкомбинации с отхаркивающими средствами - в комбинации с отхаркивающими средствами
Бифидобактеринбифидум+Кишечные - Бифидобактерин бифидум+Кишечные
якислота - я кислота
Кишечныепалочки - Кишечные палочки
генно-инженерный] - генно-инженерный]
Жировыеэмульсии - Жировые эмульсии
Аминокислотыдля - Аминокислоты для
Пропионилфенилэток- - Пропионилфенил эток-
моторикужелудочно- - моторику желудочно-
(полипазе - (по липазе
эток-сиэтилпиперидин - эток- сиэтилпиперидин
скиесредства, - ские средства,
Другиепротивомикробн - Другие противомикробн
Инсулинрастворимый - Инсулин растворимый
эмульсиидля - эмульсии для
Диметиконмг - Диметикон мг
ыепрепараты - ые препараты
липазе) - липазе )
тныесредства - тные средства
Синтетическиеантихолинергиче - Синтетические антихолинергиче
рующиефакторы - рующие факторы
[человеческийгенно- - [человеческий генно-
сиэтилпиперидинмг - сиэтилпиперидин мг
противомикробные - противомикробные
)(по - ) (по
епрепараты - е препараты
5HT3-рецепторов - 5HT3-рецепторов
Другиепротивогрибковы - Другие противогрибковы
ингибиторамибета- - ингибиторами бета-
енефротропные - е нефротропные
противогрибковые - противогрибковые
ыемикроорганизмы - ые микроорганизмы
ерентгеноконтрас - е рентгеноконтрас
серотониновых5HT3- - серотониновых 5HT3-
Производныефенилпиперидин - Производные фенилпиперидин
длялечения язвенной болезни желудка и двенадцатиперстной кишки и гастроэзофагальной рефлюксной болезни - для лечения язвенной болезни желудка и двенадцатиперстной кишки и гастроэзофагальной рефлюксной болезни
Декстрозамл 500 1000 - Декстроза мл 500 1000
заболеванийжелудочно- - заболеваний желудочно-
электролитныйбаланс - электролитный баланс
наводно- - на водно-
разбавители,включая ирригационные растворы - разбавители, включая ирригационные растворы
пидыг - пиды г
актериимлн. - актерии млн.
В25.1+ - В25.1 +
лекарственногопрепарата(3) - лекарственного препарата(3)
еско-химическая - еско- химическая
ССД(4) - ССД( 4)
Единицыизмерения - Единицы измерения
широкихсвязок - широких связок
Аналогигонадотропинрилизи - Аналоги гонадотропинрилизи
гонадотропинрилизинг - гонадотропинрилизи нг
Эстрадиолмг 2 20 - Эстрадиол мг 2 20
Дидрогестеронмг 10 100 - Дидрогестерон мг 10 100
Бромокриптинмг 2,5 25 - Бромокриптин мг 2,5 25
Прочиегематологические средства - Прочие гематологические средства
Производныекарбоксамила - Производные карбоксамила
Минералы]мл - Минералы] мл
Полусинтетическиеалкалоиды - Полусинтетические алкалоиды
[Жировыеэмульсии - [Жировые эмульсии
белладонны,четвертичные - белладонны, четвертичные
Клавулановаякислота - Клавулановая кислота
множественнымиосложнениями - множественными осложнениями
неврологическимипроявлениями - неврологическими проявлениями
продолжительностидействия и их аналоги для инъекционного введения - продолжительности действия и их аналоги для инъекционного введения
энергетическихресурсов - энергетических ресурсов
половыхорганов - половых органов
многоузловымзобом - многоузловым зобом
Серосодержащие - Серосодержащие
Селективныебета-адреноблок - Селективные бета-адреноблок
Производныетиоурацила - Производные тиоурацила
ибета-адреноблок - и бета-адреноблок
Неселективныебета-адреноблок - Неселективные бета-адреноблок
аналогидля инъекционного введения - аналоги для инъекционного введения
малеатмг - малеат мг
Нитрендипин+эналаприламалеат - Нитрендипин+эналаприла малеат
Ингибиторыдипептидилпептидазы- - Ингибиторы дипептидилпептидазы-
белладоннытретичные - белладонны третичные
позвоночногостолба - позвоночного столба
нарушенияхобмена - нарушениях обмена
етилметилоксадиазол - етил метилоксадиазол
вкачестве - в качестве
Бензилдиметил-миристоиламино-пропи - Бензилдиметил-мир истоиламино-пропи
Тимололмл - Тимолол мл
-гистидил-фенилаланил-пролил-глицил- - -гистидил-фенилала нил-пролил-глицил-
Декстранмл - Декстран мл
Гинкгодвулопастного - Гинкго двулопастного
ламмониймг - ламмоний мг
нил-пролил-глицил-пролин - нил-пролил-глицил- пролин
Тобрамицинмл - Тобрамицин мл
Бутиламиногидроксипропоксифеноксим - Бутиламиногидрокс ипропоксифеноксим
сукцинатг - сукцинат г
ипропоксифеноксиметил - ипропоксифеноксим етил
Симпатомиметики,используемые - Симпатомиметики, используемые
Дексаметазонмл - Дексаметазон мл
качестведеконгестантов - качестве деконгестантов
истоиламино-пропиламмоний - истоиламино-пропи ламмоний
идофаминергические средства - и дофаминергические средства
пролинмг - пролин мг
Метионил-глутамил-гистидил-фенилала - Метионил-глутамил -гистидил-фенилала
Добутаминмг 250 500 - Добутамин мг 250 500
Этанолмл 50 200 - Этанол мл 50 200
Бисопрололмг 10 100 - Бисопролол мг 10 100
перманганатмл 50 50 - перманганат мл 50 50
Антифибринолитические - Антифибринолитические
Антипсихотическиесредства - Антипсихотические средства
анальныхтрещин - анальных трещин
преимущественнымдействием - преимущественным действием
Антитромботическиесредства - Антитромботические средства
Ирригационныерастворы - Ирригационные растворы
встоматологии - в стоматологии
Пропранололмг 120 2400 - Пропранолол мг 120 2400
Амлодипинмг 5 100 - Амлодипин мг 5 100
лечениягеморроя - лечения геморроя
Диклофенакмг 75 225 - Диклофенак мг 75 225
Соталолмг 320 6400 - Соталол мг 320 6400
Нифедипинмг 40 800 - Нифедипин мг 40 800
Селективныеблокаторы - Селективные блокаторы
Метопрололмг 150 1500 - Метопролол мг 150 1500
Пропофолмг 200 1200 - Пропофол мг 200 1200
Тримеперидинмл 40 40 - Тримеперидин мл 40 40
Миорелаксантыпериферического - Миорелаксанты периферического
Допаминмг 200 1200 - Допамин мг 200 1200
оксибутиратмл 30 30 - оксибутират мл 30 30
Налоксонмг 20 20 - Налоксон мг 20 20
Атенололмг 100 2000 - Атенолол мг 100 2000
Дроперидолмг 5 15 - Дроперидол мг 5 15
Кеторолакмл 6 18 - Кеторолак мл 6 18
Кетаминмг 75 300 - Кетамин мг 75 300
Фентанилмг 0,075 0,4 - Фентанил мг 0,075 0,4
другиегемостатические - другие гемостатические
нижнихконечностей - нижних конечностей
Циклобарбиталмг - Циклобарбитал мг
Неселективныебета-адреноблокато - Неселективные бета-адреноблокато
Хлоропираминмг 60 300 - Хлоропирамин мг 60 300
Селективныебета2-адреномимети - Селективные бета2-адреномимети
хлорид+Натриялактат] - хлорид+Натрия лактат]
заболеванийнервной системы - заболеваний нервной системы
метил-гидроксиброминдолкарбоновой - метил-гидроксиброминдол карбоновой
Другиеиммуностимулятор - Другие иммуностимулятор
Производныепурина - Производные пурина
Klebsiellapneumoniae - Klebsiella pneumoniae
Streptococcuspneumoniae - Streptococcus pneumoniae
Pseudomonas(синегнойной - Pseudomonas (синегнойной
другимистрептококками - другими стрептококками
инфекционнымивозбудителями - инфекционными возбудителями
аэробнымиграмотрицательными - аэробными грамотрицательными
стрептококкомгруппы - стрептококком группы
+[Тазобактам] - +[Тазобактам]
четвертогопоколения - четвертого поколения
вирусне - вирус не
средствасистемного действия для лечения обструктивных заболеваний дыхательных путей - средства системного действия для лечения обструктивных заболеваний дыхательных путей
аминометил-гидроксиброминдол - аминометил-гидроксиброминдо л
Метилфенилтиометил-диметиламинометил-гидроксиброминдо - Метилфенилтиометил-диметил аминометил-гидроксиброминдо
множественнойлокализации - множественной локализации
инеуточненной - и неуточненной
аминометилгидроксиброминдол - аминометилгидроксиброминдо л
Метилфенилтиометилдиметиламинометилгидроксиброминдо - Метилфенилтиометилдиметил аминометилгидроксиброминдо
Комбинированныепротивотуберкулезные - Комбинированные противотуберкулезные
Протионамид+ - Протионамид +
Этамбутолг - Этамбутол г
низкойактивностью (группа - низкой активностью (группа
почечныхканальцев, - почечных канальцев,
почечныхканальцев - почечных канальцев
[III]гидроксид - [III] гидроксид
Аскорбиноваякислота+ - Аскорбиновая кислота+
дигидропиридина - дигидропиридина
Производныебензодиазепина 10 - Производные бензодиазепина 10
Левотироксиннатрия - Левотироксин натрия
кислота+доз - кислота+ доз
гидрокарбонатг - гидрокарбонат г
натриямкг - натрия мкг
Микофенолатамофетил - Микофенолата мофетил
мофетилг - мофетил г
Ленограстим - Ленограстим
Цианокобаламин - Цианокобаламин
Эпоэтинбета - Эпоэтин бета
Паклитаксел - Паклитаксел
тиммг - тим мг
иэтилпиперидин - иэтилпипер идин
Другиепротивоэпилепти - Другие противоэпилепти
онмг - он мг
Пэгфилграстим - Пэгфилграстим
аминмкг - амин мкг
Парацетамол - Парацетамол
Метоклопрамид - Метоклопрамид
амидмг - амид мг
Пиридоксин - Пиридоксин
Прочиепротивоопухолев ые препараты - Прочие противоопухолев ые препараты
Трописетрон - Трописетрон
Фторурацил - Фторурацил
Карбоплатин - Карбоплатин
Аскорбиновая - Аскорбиновая
Ондансетрон - Ондансетрон
фенилэтоксиэтилпипер - фенилэтокс иэтилпипер
Другиеантианемические препараты - Другие антианемические препараты
Гранисетрон - Гранисетрон
Дексаметазон - Дексаметазон
инмкг - ин мкг
циловаякислота - циловая кислота
кмг - к мг
имагния - и магния
Дарбэпоэтин - Дарбэпоэтин
Эпирубицин - Эпирубицин
Бупренорфин - Бупренорфин
Диклофенак - Диклофенак
низкоосмолярныерентгеноконтраст - низкоосмолярные рентгеноконтраст
Молграмостим - Молграмостим
Ацетилсалициловая - Ацетилсалициловая
аминмг - амин мг
гемостатическиесредства системного действия - гемостатические средства системного действия
кислотамл 100 500 - кислота мл 100 500
натрия+Питофенон+Фенпивериниябромид - натрия+Питофенон+Фенпивериния бромид
Метамизолнатрия+Питофенон+Фенпивериния - Метамизол натрия+Питофенон+Фенпивериния
Неселективныебета-адреноблока - Неселективные бета-адреноблока
ибета-адреноблока - и бета-адреноблока
Селективныебета-адреноблока - Селективные бета-адреноблока
выхрецепторов - вых рецепторов
бныепрепараты - бные препараты
идвенадцатипе - и двенадцатипе
шечноготракта - шечного тракта
гастроэзофагальной - гастроэзофага льной
льнойрефлюксной - льной рефлюксной
моторикижелудочно-ки - моторики желудочно-ки
рефлюкснойболезни - рефлюксной болезни
Висмутатрикалия - Висмута трикалия
двенадцатиперстной - двенадцатиперстной
Алюминияфосфат - Алюминия фосфат
игастроэзофага - и гастроэзофага
фосфатг - фосфат г
Другиепрепараты - Другие препараты
Магниягидроксид - Магния гидроксид
Другиепротивомикро - Другие противомикро
Кальциякарбонат+Колекальцифер - Кальция карбонат+Колекальцифер
глюконатмг 1500 7500 - глюконат мг 1500 7500
Сальмонеллезныйэнтерит - Сальмонеллезный энтерит
иеантихолинерг - ие антихолинерг
Синтетические - Синтетические
ическиесредства, - ические средства,
наводно-электр - на водно-электр
микроорганизмы - микроорганизмы
Препаратыугля - Препараты угля
третичнойаминогруппо й - третичной аминогруппо й
ейныемикрооргани - ейные микрооргани
олитныйбаланс - олитный баланс
питаниямг - питания мг
нефротропныевысокоосмолярные рентгеноконтрастные средства - нефротропные высокоосмолярные рентгеноконтрастные средства
Растворителииразбавители, - Растворители иразбавители,
Природныеалкалоиды - Природные алкалоиды
хлоридмл 400 4000 - хлорид мл 400 4000
низкоосмолярныерентгеноконтраст-ные - низкоосмолярные рентгеноконтраст-ные
рентгеноконтраст-ныесредства - рентгеноконтраст-ные средства
и-этилпиперидинмг - и-этилпиперидин мг
общиеанестетики - общие анестетики
родственныхструктур - родственных структур
Цефалоспоринычетвертого - Цефалоспорины четвертого
Цефалоспориныпервого - Цефалоспорины первого
Ванкомицинмг 2000 20000 - Ванкомицин мг 2000 20000
Другиепсихостимуляторы и ноотропные препараты - Другие психостимуляторы и ноотропные препараты
Папаверин+Фенобарбиталмл - Папаверин+Фенобарбитал мл
Лидокаинмг 200 600 - Лидокаин мг 200 600
кислотаи ее производные - кислота и ее производные
оноваякислота - оновая кислота
Левофлоксацин - Левофлоксацин
+[Клавулано - + [Клавулано
Надропарин - Надропарин
идмг - ид мг
Фенилэфрин - Фенилэфрин
Ингибиторыпротонного - Ингибиторы протонного
масса30000-4000 - масса 30000-4000
Галоперидол - Галоперидол
Кортикостероидыс - Кортикостероиды с
линоваякислота - линовая кислота
ьногопитания - ьного питания
Амоксициллин - Амоксициллин
Гидроксиалюминия - Гидроксиалюминия
Цефтриаксон - Цефтриаксон
Суксаметония - Суксаметония
Тиопенталнатрия - Тиопентал натрия
офенмг - офен мг
человекамл - человека мл
магнияаспарагина - магния аспарагина
ммг - м мг
Микафунгин - Микафунгин
Гепариннатрия - Гепарин натрия
парентерального - парентерального
Рибофлавин - Рибофлавин
Цефоперазон - Цефоперазон
юминиятрисульфо - юминия трисульфо
Севофлуран - Севофлуран
гидрокарбонат - гидрокарбонат
Адренергическиеи - Адренергические и
метилсульфат - метилсульфат
Далтепариннатрия - Далтепарин натрия
цинмг - цин мг
Кетопрофен - Кетопрофен
Карбамазепин - Карбамазепин
[Сульбактам] - [Сульбактам]
сацинмг - сацин мг
еинмг - еин мг
Цефуроксим - Цефуроксим
йодидмг - йодид мг
Альбуминчеловека - Альбумин человека
аспарагинат - аспарагинат
Магниясульфат - Магния сульфат
дммоль - д ммоль
Декстран[ср. - Декстран [ср.
трисульфофталоциани - трисульфо фталоциани
Гидрокортизон - Гидрокортизон
бромидмг - бромид мг
Натрияоксибутира - Натрия оксибутира
наметилсульф - на метилсульф
Флуконазол - Флуконазол
Цефотаксим - Цефотаксим
мол.масса - мол. масса
дляпарентерал - для парентерал
золмг - зол мг
Пропафенон - Пропафенон
Рокурониябромид - Рокурония бромид
Метронидазол - Метронидазол
Преднизолон - Преднизолон
+[Сульбакта - + [Сульбакта
Дроперидол - Дроперидол
ламинмкг - ламин мкг
фталоцианин - фталоциани н
зонмг - зон мг
[Клавулановая - [Клавулано вая
Неостигмина - Неостигмина
Пропионилфенилэтокс - Пропионил фенилэтокс
кислотамг 200 1000 - кислота мг 200 1000
Хлоропирамин - Хлоропирамин
Пипекурония - Пипекурония
Инсулинаспарт - Инсулин аспарт
ваякислота] - вая кислота]
фотодинамической/ - фотодинамической /
минмг - мин мг
Гадодиамид - Гадодиамид
Тримеперидин - Тримеперидин
оваякислота - овая кислота
Аминолевулиновая - Аминолевулиновая
оксибутират - оксибутират
Лорноксикам - Лорноксикам
илкрахмалмл - илкрахмал мл
Натриягидрокарбо - Натрия гидрокарбо
Цефалоспоринытретьего поколения - Цефалоспорины третьего поколения
натмг - нат мг
0]мл - 0] мл
сульфатмг - сульфат мг
Эноксапарин - Эноксапарин
Протаминасульфат - Протамина сульфат
леченияпсориаза - лечения псориаза
атмг - ат мг
Прокаинамид - Прокаинамид
ыемикроорганизм - ые микроорганизм
Бифидобактерии - Бифидобактерии
пероксидмл - пероксид мл
Активированный - Активированный
моторикужелудочно-киш - моторику желудочно-киш
Другиепротивогрибков - Другие противогрибков
ыерентгеноконтрас - ые рентгеноконтрас
Синтетическиеантихолинергич - Синтетические антихолинергич
идезинфицирую - и дезинфицирую
Водородапероксид - Водорода пероксид
нефротропныенизкоосмолярн - нефротропные низкоосмолярн
серотониновых5НТЗ-рецепторо - серотониновых 5НТЗ-рецепторо
антианемические - антианемические
илэтоксиэтилпиперидин - илэтоксиэтилпи перидин
Другиеантианемически - Другие антианемически
субтилисдоз - субтилис доз
Бациллюссубтилис - Бациллюс субтилис
Производныефенилпипериди - Производные фенилпипериди
ирующиефакторы - ирующие факторы
Пропионилфенилэтоксиэтилпи - Пропионилфен илэтоксиэтилпи
Метамизолнатрия+Питофенон+ - Метамизол натрия+Питофенон+
натрия+Питофенон+мл - натрия+Питофенон+ мл
антихолинергическиесредства, эфиры с третичной группой - антихолинергические средства, эфиры с третичной группой
сиэтил-пиперидинмг - сиэтил-пиперидин мг
Пропионилфенилэтоксиэти-пиперидин - Пропионилфенилэтокс иэти-пиперидин
иэти-пиперидинмг - иэти-пиперидин мг
Пропионилфенилэтоксиэтил- - Пропионилфенилэтоксиэт ил-
натрия+ - натрия +
Фенобарбиталмг - Фенобарбитал мг
новообразованиемолочной - новообразование молочной
Бупивакаин - Бупивакаин
Прегабалин - Прегабалин
В12(цианокобалам - В12 (цианокобалам
Агонистыимидазолинов - Агонисты имидазолинов
дляинъекционног - для инъекционног
инъекционного - инъекционного
ныеуглеводороды - ные углеводороды
гистаминовых рецепторов - гистамино вых рецепторов
Нитроглицерин - Нитроглицерин
имидазолиновых - имидазолиновых
еринмг - ерин мг
Далтепарин - Далтепарин
дляпарентерально - для парентерально
скиепрепараты, - ские препараты,
(цианокобаламин - (цианокобаламин
Антиаритмические - Антиаритмические
Нимодипин - Нимодипин
ныерентгеноконтр астные средства - ные рентгеноконтр астные средства
изонмг - изон мг
Дротаверин - Дротаверин
Неселективные - Неселективные
Цефалоспорины 2-го поколения - Цефалоспорин ы 2-го поколения
препараты,класс - препараты, класс
Галогенированные - Галогенированные
Группагепарина - Группа гепарина
Адренергические - Адренергические
Амитриптилин - Амитриптилин
ацинмг - ацин мг
Ропивакаин - Ропивакаин
линмг - лин мг
Производныефенилалкилам - Производные фенилалкилам
аммг - ам мг
фенилэтоксиэтилпипе - фенилэтокс иэтилпипе
Алпразолам - Алпразолам
Производныедигидропирид - Производные дигидропирид
идофаминергич - и дофаминергич
Йогексолмг 300 300 - Йогексол мг 300 300
кислотамг 30000 30000 - кислота мг 30000 30000
Иокситаламоваякислота - Иокситаламовая кислота
Аминометилбензойнаякислота - Аминометилбензойная кислота
иэтил-пиперидинмг - иэтил-пиперидин мг
Папаверин+Платифиллин - Папаверин+Платифилл ин
обактериидоз - обактерии доз
леченияпсориаза для наружного применения - лечения псориаза для наружного применения
масса30000-40000] - масса 30000-40000]
бета[метоксиполиэтиленглико - бета [метоксиполиэтиленглико
ль]мг - ль] мг
Производныеподофил-лотоксина - Производные подофил-лотоксина
Дезиитоксикационныепрепараты - Дезиитоксикационные препараты
хлоридмг 240 720 - хлорид мг 240 720
серотониновых5НТЗ - серотониновых 5НТЗ
ийг - ий г
дляинъекций - для инъекций
Смектитдиоктаэдрическ - Смектит диоктаэдрическ
Глицирризиновая - Глицирризиновая
тиосульфатмг - тиосульфат мг
Синтетическиеантихолинергич еские средства, эфиры с третичной аминогруппой - Синтетические антихолинергич еские средства, эфиры с третичной аминогруппой
Натриятиосульфат - Натрия тиосульфат
диоктаэдрический - диоктаэдрический
Адсорбирующие - Адсорбирующие
инъекциймл - инъекций мл
Пентоксифиллин - Пентоксифиллин
Глицирризиноваякислота+Фосфолип - Глицирризиновая кислота+Фосфолип
кислота+Фосфолипиды - кислота+Фосфолип иды
л-пиперидинмг - л-пиперидин мг
нефротропныенизкоосмолярные рентгеноконтрастные средства - нефротропные низкоосмолярные рентгеноконтрастные средства
первогопоколения - первого поколения
Другиеминеральные вещества - Другие минеральные вещества
Декстран[ср.мол.масса - Декстран [ср.мол.масса
Аминодигидрофталазиндионнатрия - Аминодигидрофталазиндион натрия
избыточнымпоступлением - избыточным поступлением
натолерантность - на толерантность
Кеторолакмг 30 900 - Кеторолак мг 30 900
Стимуляторымоторики желудочно-кишечного тракта - Стимуляторы моторики желудочно-кишечного тракта
Водамл 500 5000 разбавители, включая ирригационные растворы - Вода мл 500 5000 разбавители, включая ирригационные растворы
Метионин+Фосфолипиды - Метионин+Фосфоли пиды
тин]мг - тин] мг
Леводопа+[Карбидопа] - Леводопа+[Карбидоп а]
кислотамг 16000 160000 - кислота мг 16000 160000
инъекциймл 500 5000 - инъекций мл 500 5000
а]мг - а] мг
ииммуномодуляторы - и иммуномодуляторы
второгопоколения - второго поколения
Противоопухолевыепрепараты - Противоопухолевые препараты
мофетилмг - мофетил мг
полостейгрудной - полостей грудной
поколения' - поколения '
предоставлениямедицинской - предоставления медицинской
стороныплаценты, - стороны плаценты,
свыходом - с выходом
помощиматери, - помощи матери,
{Калияхлорид - {Калия хлорид
Циластатинмг - Циластатин мг
Натриялактат} - Натрия лактат}
хлорид}мл - хлорид} мл
Сульбактаммг - Сульбактам мг
лактат}мл - лактат} мл
Пропионилфенилэтоксиэтилпипеидин - Пропионилфенилэтокси этилпипеидин
этилпипеидинмг - этилпипеидин мг
Rho{D}мг - Rho{D} мг
Натрияхлорид} - Натрия хлорид}
Антибактериальныесредства - Антибактериальные средства
сложный{Калия - сложный {Калия
Триазолапроизводные - Триазола производные
плодныхоболочек - плодных оболочек
пенициллинов,включая комбинации с ингибиторами бета-лактамаз - пенициллинов, включая комбинации с ингибиторами бета-лактамаз
{D}мг - {D} мг
желудка,12-перстной - желудка, 12-перстной
Урсодезоксихолевая - Урсодезоксихолевая
призаболеваниях - при заболеваниях
дляэрадикации - для эрадикации
йг - й г
масломг - масло мг
частотыпредоставлении - частоты предоставлении
Тыквыобыкновенной - Тыквы обыкновенной
Смектитдиоктаэдрически - Смектит диоктаэдрически
лечебногопитания - лечебного питания
обыкновеннойсемян - обыкновенной семян
диметиламинометил-г - диметиламинометил- г
минеральнымивеществами - минеральными веществами
алыг - алы г
Метилфенилтиометил-диметиламинометил- - Метилфенилтиометил-диметиламинометил-
сминеральными - с минеральными
препаратыг - препараты г
белковдля - белков для
бактам]г - бактам] г
препаратыалюминия, - препараты алюминия,
двенадцатиперстнойкишки и гастроэзофагальной рефлюксной болезни - двенадцатиперстной кишки и гастроэзофагальной рефлюксной болезни
(парентеральноевведение) - (парентеральное введение)
Поливитамины(парентеральное - Поливитамины (парентеральное
Поливитамины+Минералы - Поливитамины+Минер алы
икомплексные - и комплексные
гидроксиброминдолкарбоновой - гидроксиброминдол карбоновой
карбонат+Колекальциферолг - карбонат+Колекальциферол г
иламинометил-гидроксиброминдол - иламинометил-гидроксибром индол
парентеральногог - парентерального г
альфа(фно-альфа) - альфа (фно-альфа)
игастроэзофагальной рефлюксной болезни - и гастроэзофагальной рефлюксной болезни
Поливитамины[парентеральное - Поливитамины [парентеральное
введение]доз - введение] доз
Метилфенилтиометил-диметиламинометил-гидроксибром - Метилфенилтиометил-димет иламинометил-гидроксибром
эфирг - эфир г
Ко-тримоксазол[Сульфаметоксазол+Трим - Ко-тримоксазол [Сульфаметоксазол+Трим
[Сульфаметоксазол+Триммг - [Сульфаметоксазол+Трим мг
Моноклоналъныеантитела - Моноклоналъные антитела
кромегепарина - кроме гепарина
сульфаниламидови триметоприма, включая производные - сульфаниламидов и триметоприма, включая производные
гастроэзофагеальнойрефлюксной - гастроэзофагеальной рефлюксной
Ко-тримоксазол[Сульфаметоксазол+ - Ко-тримоксазол [Сульфаметоксазол+
+[Циластатин] - + [Циластатин]
нестероидныепротивовоспалительны - нестероидные противовоспалительны
[Циластатин]мг - [Циластатин] мг
язвеннойболезни желудка и двенадцатиперстной кишки и гастроэзофагальной рефлюксной болезни - язвенной болезни желудка и двенадцатиперстной кишки и гастроэзофагальной рефлюксной болезни
антицитомегаловирусныймг - антицитомегаловирусный мг
ипротиворевматическ - и противоревматическ
Каптоприлмг 50 1050 - Каптоприл мг 50 1050
опухолиальфа ( - опухоли альфа (
бензодиазепина1Ю0 - бензодиазепина 1Ю0
лактат)мл - лактат) мл
(метоксиполиэтиленгликоль) - (метоксиполиэтиленгликоль )
Натрияхлорид) - Натрия хлорид)
бета(метоксиполиэтиленгликоль - бета (метоксиполиэтиленгликоль
хлорид)мл - хлорид) мл
альфа(активированный) - альфа (активированный)
(активированный)мг - (активированный) мг
Rho(D)мг - Rho(D) мг
всочетании - в сочетании
Симетиконмл - Симетикон мл
ветрогоннымипрепаратами - ветрогонными препаратами
значительнойпротеинурии - значительной протеинурии
присоединившейсяпротеинурией - присоединившейся протеинурией
+прочие - + прочие
{активированный}мг - {активированный} мг
альфа{активированный} - альфа {активированный}
Алтихолинэстеразныесредства - Алтихолинэстеразные средства
IXи - IX и
аферезнаякарантинизированная - аферезная карантинизированная
карантинизированнаямл - карантинизированная мл
плазмааферезная - плазма аферезная
производныефенилпиперидина - производные фенилпиперидина
Антихолинэстеразные средства - Антихолинэстеразные средства
затылочномпредлежании - затылочном предлежании
ягодичномпредлежании - ягодичном предлежании
этил-пиперидинмг - этил-пиперидин мг
употреблениемопиоидов - употреблением опиоидов
употреблениемлетучих - употреблением летучих
употреблениемседативных - употреблением седативных
употреблениемканнабиоидов - употреблением каннабиоидов
употреблениемкокаина - употреблением кокаина
употреблениемалкоголя - употреблением алкоголя
гдеозначает, что данное мероприятие проводится 100% пациентов, соответствующих данной модели, а цифры менее 1 - указанному в стандарте медицинской помощи проценту пациентов, имеющих соответствующие медицинские показания. - где означает, что данное мероприятие проводится 100% пациентов, соответствующих данной модели, а цифры менее 1 - указанному в стандарте медицинской помощи проценту пациентов, имеющих соответствующие медицинские показания.
2-пирролидонмг - 2-пирролидон мг
Производныедифенил-метана - Производные дифенил-метана
-диметилатмл - -диметилат мл
Диметилоксобутилфосфонил-диметилат - Диметилоксобутилфосфонил -диметилат
несколькихнаркотических - нескольких наркотических
вызванныйодновременным - вызванный одновременным
употреблениемдругих - употреблением других
Гамма-аминомаслянаякислота - Гамма-аминомасляная кислота
диметилатмл - диметилат мл
-диазепинмг - -диазепин мг
-пирролидонмг - -пирролидон мг
Прочиепротивомикробные - Прочие противомикробные
снотворныхвеществ - снотворных веществ
включаякофеин - включая кофеин
бензо-диазепинмг - бензо-диазепин мг
приалкогольной зависимости - при алкогольной зависимости
онилдиметилатмл - онилдиметилат мл
нил-2-пирролидонмг - нил-2-пирролидон мг
стимуляторов,включая - стимуляторов, включая
-бензо-диазепинмг - -бензо-диазепин мг
Дифенгидраминмг 30 150 - Дифенгидрамин мг 30 150
Бромдигидрохлорфенил-бензо-диазепин - Бромдигидрохлорфенил -бензо-диазепин
онил-диметилатмл - онил-диметилат мл
Диметилоксобутилфос-фонил-диметилат - Диметилоксобутилфос- фонил-диметилат
фонил-диметилатмл - фонил-диметилат мл
Димеркаптопропансуль-фонат - Димеркаптопропансуль- фонат
кислотамг 3000 45000 - кислота мг 3000 45000
оротатмг - оротат мг
нил-бензодиазепинмг - нил-бензодиазепин мг
аминомаслянаякислота - аминомасляная кислота
Бромдигидрохлорфенил-бензодиазепин - Бромдигидрохлорфе нил-бензодиазепин
магнияоротат - магния оротат
осфонилдиметилатмл - осфонилдиметилат мл
N-карбамоилметил-4-фенил-2- - N-карбамоилметил-4- фенил-2-
Диметилоксобутил-фосфонилдиметилат - Диметилоксобутил-фосфонил диметилат
наркотическихсредств - наркотических средств
сфонил-диметилатмл - сфонил-диметилат мл
заболеванийжелудочно-кишечн - заболеваний желудочно-кишечн
Неселективныебета-адреноблокат - Неселективные бета-адреноблокат
зо-диазепинмг - зо-диазепин мг
++Фосфолипиды - + +Фосфолипиды
л-диметилатмл - л-диметилат мл
-2-пирролидонмг - -2-пирролидон мг
М-карбамоилметил-4-фенил-2-пирролидон - М-карбамоилметил-4-фенил- 2-пирролидон
№-карбамоилметил-4-фенил-2-пирролидон - №-карбамоилметил-4-фе нил-2-пирролидон
Мидазоламмг 3,5 35 - Мидазолам мг 3,5 35
